a little	//
abandon	/ə'bændən/
abandoned	/ə'bændənd/
ability	/ə'biliti/
able	/'eibl/
about	/ə'baut/
above	/ə'bʌv/
abroad	/ə'brɔ:d/
absence	/'æbsəns/
absent	/'æbsənt/
absolute	/'æbsəlu:t/
absolutely	/'æbsəlu:tli/
absorb	/əb'sɔ:b/
abuse	/ə'bju:s/
academic	/,ækə'demik/
accent	/'æksənt/
accept	/ək'sept/
acceptable	/ək'septəbl/
access	/'ækses/
accident	/'æksidənt/
accidental	/,æksi'dentl/
accidentally	/,æksi'dentəli/
accommodation	/ə,kɔmə'deiʃn/
accompany	/ə'kʌmpəni/
according to	/ə'kɔ:diɳ/
account	/ə'kaunt/
accurate	/'ækjurit/
accurately	/'ækjuritli/
accuse	/ə'kju:z/
achieve	/ə'tʃi:v/
achievement	/ə'tʃi:vmənt/
acid	/'æsid/
acknowledge	/ək'nɔlidʤ/
acquire	/ə'kwaiə/
across	/ə'krɔs/
act	/ækt/
action	/'ækʃn/
active	/'æktiv/
actively	/'æktivli/
activity	/æk'tiviti/
actor	/'æktə/
actress	/'æktris/
actual	/'æktjuəl/
actually	/'æktjuəli/
adapt	/ə'dæpt/
add	/æd/
addition	/ə'diʃn/
additional	/ə'diʃənl/
address	/ə'dres/
adequate	/'ædikwit/
adequately	/'ædikwitli/
adjust	/ə'dʤʌst/
admiration	/,ædmə'reiʃn/
admire	/əd'maiə/
admit	/əd'mit/
adopt	/ə'dɔpt/
adult	/'ædʌlt/
advance	/əd'vɑ:ns/
advanced	/əd'vɑ:nst/
advantage	/əb'vɑ:ntidʤ/
adventure	/əd'ventʃə/
advertise	/'ædvətaiz/
advertisement	/əd'və:tismənt/
advertising	//
advice	/əd'vais/
advise	/əd'vaiz/
affair	/ə'feə/
affect	/ə'fekt/
affection	/ə'fekʃn/
afford	/ə'fɔ:d/
afraid	/ə'freid/
after	/'ɑ:ftə/
afternoon	/'ɑ:ftə'nu:n/
afterwards	/'ɑ:ftəwəd/
again	/ə'gen/
against	/ə'geinst/
age	/eidʤ/
aged	/'eidʤid/
agency	/'eidʤənsi/
agent	/'eidʤənt/
aggressive	/ə'gresiv/
ago	/ə'gou/
agree	/ə'gri:/
agreement	/ə'gri:mənt/
ahead	/ə'hed/
aid	/eid/
aim	/eim/
air	/eə/
aircraft	/'eəkrɑ:ft/
airport	//
alarm	/ə'lɑ:m/
alarmed	/ə'lɑ:m/
alarming	/ə'lɑ:miɳ/
alcohol	/'ælkəhɔl/
alcoholic	/,ælkə'hɔlik/
alive	/ə'laiv/
all	/ɔ:l/
all right	/'ɔ:l'rait/
allied	/ə'laid/
allow	/ə'lau/
ally	/'æli/
almost	/'ɔ:lmoust/
alone	/ə'loun/
along	/ə'lɔɳ/
alongside	/ə'lɔɳ'said/
aloud	/ə'laud/
alphabet	/'ælfəbit/
alphabetical	/,æflə'betikl/
alphabetically	/,ælfə'betikəli/
already	/ɔ:l'redi/
also	/'ɔ:lsou/
alter	/'ɔ:ltə/
alternative	/ɔ:l'tə:nətiv/
alternatively	//
although	/ɔ:l'ðou/
altogether	/,ɔ:ltə'geðə/
always	/'ɔ:lwəz/
amaze	/ə'meiz/
amazed	/ə'meiz/
amazing	/ə'meiziɳ/
ambition	/æm'biʃn/
ambulance	/'æmbjuləns/
among, amongst	/ə'mʌɳ/
amount	/ə'maunt/
amuse	/ə'mju:z/
amused	/ə'mju:zd/
amusing	/ə'mju:ziɳ/
analyse, analyze	/'ænəlaiz/
analysis	/ə'næləsis/
ancient	/'einʃənt/
and	/ænd, ənd, ən/
anger	/'æɳgə/
angle	/'æɳgl/
angrily	/'æɳgrili/
angry	/'æɳgri/
animal	/'æniməl/
ankle	/'æɳkl/
anniversary	/,æni'və:səri/
announce	/ə'nauns/
annoy	/ə'nɔi/
annoyed	/ə'nɔid/
annoying	/ə'nɔiiɳ/
annual	/'ænjuəl/
annually	/'ænjuəli/
another	/ə'nʌðə/
answer	/'ɑ:nsə/
anti	//
anticipate	/æn'tisipeit/
anxiety	/æɳ'zaiəti/
anxious	/'æɳkʃəs/
anxiously	/'æɳkʃəsli/
any	//
anyone (anybod)	/'eniwʌn/
anything	/'eniθiɳ/
anyway	/'eniwei/
anywhere	/'eniweə/
apart	/ə'pɑ:t/
apart from	/ə'pɑ:t/
apart from, aside from	//
apartment	/ə'pɑ:tmənt/
apologize	/ə'pɔlədʤaiz/
apparent	/ə'pærənt/
apparently	//
appeal	/ə'pi:l/
appear	/ə'piə/
appearance	/ə'piərəns/
apple	/'æpl/
application	/,æpli'keiʃn/
apply	/ə'plai/
appoint	/ə'pɔint/
appointment	/ə'pɔintmənt/
appreciate	/ə'pri:ʃieit/
approach	/ə'proutʃ/
appropriate (to, for)	/ə'proupriit/
approval	/ə'pru:vəl/
approve	/ə'pru:v/
approving	/ə'pru:viɳ/
approximate	/ə'prɔksimit/
approximately	/ə'prɔksimitli/
April (abbr Apr)	/'eiprəl/
area	/'eəriə/
argue	/'ɑ:gju:/
argument	/'ɑ:gjumənt/
arise	/ə'raiz/
arm	/ɑ:m/
armed	/ɑ:md/
arms	//
army	/'ɑ:mi/
around	/ə'raund/
arrange	/ə'reindʤ/
arrangement	/ə'reindʤmənt/
arrest	/ə'rest/
arrival	/ə'raivəl/
arrive (at, in)	/ə'raiv/
arrow	/'ærou/
art	/ɑ:t/
article	/'ɑ:tikl/
artificial	/,ɑ:ti'fiʃəl/
artificially	/,ɑ:ti'fiʃəli/
artist	/'ɑ:tist/
artistic	/ɑ:'tistik/
as	/æz, əz/
as well	//
ashamed	/ə'ʃeimd/
aside	/ə'said/
ask	/ɑ:sk/
asleep	/ə'sli:p/
aspect	/'æspekt/
assist	/ə'sist/
assistance	/ə'sistəns/
assistant	/ə'sistənt/
associate	/ə'souʃiit/
association	/ə,sousi'eiʃn/
assume	/ə'sju:m/
assure	/ə'ʃuə/
atmosphere	/'ætməsfiə/
atom	/'ætəm/
attach	/ə'tætʃ/
attached	//
attack	/ə'tæk/
attempt	/ə'tempt/
attempted	/ə'temptid/
attend	/ə'tend/
attention	/ə'tenʃn/
attitude	/'ætitju:d/
attorney	/ə'tə:ni/
attract	/ə'trækt/
attraction	/ə'trækʃn/
attractive	/ə'træktiv/
audience	/'ɔ:djəns/
August (abbr Aug)	/'ɔ:gəst - ɔ:'gʌst/
aunt	/ɑ:nt/
author	/'ɔ:θə/
authority	/ɔ:'θɔriti/
automatic	/,ɔ:tə'mætik/
automatically	//
autumn	/'ɔ:təm/
available	/ə'veiləbl/
average	/'ævəridʤ/
avoid	/ə'vɔid/
awake	/ə'weik/
award	/ə'wɔ:d/
aware	/ə'weə/
away	/ə'wei/
awful	/'ɔ:ful/
awfully	//
awkward	/'ɔ:kwəd/
awkwardly	//
back	/bæk/
background	/'bækgraund/
backward	/'bækwəd/
backwards	/'bækwədz/
bacteria	/bæk'tiəriəm/
bad	/bæd/
badly	/'bædli/
bad-tempered	/'bæd'tempəd/
bag	/bæg/
baggage	/'bædidʤ/
bake	/beik/
balance	/'bæləns/
ball	/bɔ:l/
ban	/bæn/
band	/bænd/
bandage	/'bændidʤ/
bank	/bæɳk/
bar	/bɑ:/
bargain	/'bɑ:gin/
barrier	/bæriə/
base	/beis/
basic	/'beisik/
basically	/'beisikəli/
basis	/'beisis/
bath	/bɑ:θ/
bathroom	//
battery	/'bætəri/
battle	/'bætl/
bay	/bei/
be sick	//
beach	/bi:tʃ/
beak	/bi:k/
bear	/beə/
beard	/biəd/
beat	/bi:t/
beautiful	/'bju:təful/
beautifully	/'bju:təfuli/
beauty	/'bju:ti/
because	/bi'kɔz/
become	/bi'kʌm/
bed	/bed/
bedroom	/'bedrum/
beef	/bi:f/
beer	/bi:ə/
before	/bi'fɔ:/
begin	/bi'gin/
beginning	/bi'giniɳ/
behalf	/bi:hɑ:f/
behalf, on sb’s behalf	//
behave	/bi'heiv/
behaviour, behavior	//
behind	/bi'haind/
belief	/bi'li:f/
believe	/bi'li:v/
bell	/bel/
belong	/bi'lɔɳ/
below	/bi'lou/
belt	/belt/
bend	/bentʃ/
beneath	/bi'ni:θ/
benefit	/'benifit/
bent	/bent/
beside	/bi'said/
bet	/bet/
better, best	/betə, best/
betting	/beting/
between	/bi'twi:n/
beyond	/bi'jɔnd/
bicycle (bike)	/baisikl/
bid	/bid/
big	/big/
bill	/bil/
bin	/bin/
biology	/bai'ɔlədʤi/
bird	/bə:d/
birth	/bə:θ/
birthday	/'bə:θdei/
biscuit	/'biskit/
bit	/bit/
bite	/bait/
bitter	/'bitə/
bitterly	/'bitəli/
black	/blæk/
blade	/bleid/
blame	/bleim/
blank	/blæɳk/
blankly	/'blæɳkli/
blind	/blaind/
block	/blɔk/
blonde (blond)	/blɔnd/
blood	/blʌd/
blow	/blou/
blue	/blu:/
board	/bɔ:d/
boat	/bout/
body	/'bɔdi/
boil	/bɔil/
bomb	/bɔm/
bone	/boun/
book	/buk/
boot	/bu:t/
border	/'bɔ:də/
bore	/bɔ:/
bored	//
boring	/'bɔ:riɳ/
born ( be born)	/bɔ:n/
borrow	/'bɔrou/
boss	/bɔs/
both	/bouθ/
bother	/'bɔðə/
bottle	/'bɔtl/
bottom	/'bɔtəm/
bound (bound to)	/baund/
bowl	/boul/
box	/bɔks/
boy	/bɔi/
boyfriend	//
brain	/brein/
branch	/brɑ:ntʃ/
brand	/brænd/
brave	/breiv/
bread	/bred/
break	/breik/
breakfast	/'brekfəst/
breast	/brest/
breath	/breθ/
breathe	/bri:ð/
breathing	/'bri:ðiɳ/
breed	/bri:d/
brick	/brik/
bridge	/bridʤ/
brief	/bri:f/
briefly	/'bri:fli/
bright	/brait/
brightly	/braitli/
brilliant	/'briljənt/
bring	/briɳ/
broad	/broutʃ/
broadcast	/'brɔ:dkɑ:st/
broadly	/'brɔ:dli/
broken	/'broukən/
brother	/'brΔðз/
brown	/braun/
brush	/brΔ∫/
bubble	/'bΔbl/
budget	/ˈbʌdʒɪt/
build	/bild/
building	/'bildiŋ/
bullet	/'bulit/
bunch	/bΛnt∫/
burn	/bə:n/
burnt	/bə:nt/
burst	/bə:st/
bury	/'beri/
bus	/bʌs/
bush	/bu∫/
business	/'bizinis/
businessman, businesswoman	//
busy	/´bizi/
but	/bʌt/
butter	/'bʌtə/
button	/'bʌtn/
buy	/bai/
buyer	/´baiə/
by	/bai/
bye	/bai/
cabinet	/'kæbinit/
cable	/'keibl/
cake	/keik/
calculate	/'kælkjuleit/
calculation	/,kælkju'lei∫n/
call	/kɔ:l/
calm	/kɑ:m/
calmly	/kɑ:mli/
camera	/kæmərə/
camp	/kæmp/
campaign	/kæmˈpeɪn/
camping	/kæmpiη/
can	/kæn/
cancel	/´kænsəl/
cancer	/'kænsə/
candidate	/'kændidit/
candy	/´kændi/
cap	/kæp/
capable	/'keipәb(ә)l/
capacity	/kə'pæsiti/
capital	/ˈkæpɪtl/
captain	/'kæptin/
capture	/'kæptʃə/
car	/kɑ:/
card	/kɑ:d/
cardboard	/´ka:d¸bɔ:d/
care	/kɛər/
career	/kə'riə/
careful	/'keəful/
carefully	/´kɛəfuli/
careless	/´kɛəlis/
carelessly	//
carpet	/'kɑ:pit/
carrot	/´kærət/
carry	/ˈkæri/
case	/keis/
cash	/kæʃ/
cast	/kɑ:st/
castle	/'kɑ:sl/
cat	/kæt/
catch	/kætʃ/
category	/'kætigəri/
cause	/kɔ:z/
CD	//
cease	/si:s/
ceiling	/ˈsilɪŋ/
celebrate	/'selibreit/
celebration	/,seli'breiʃn/
cell	/sel/
cellphone, cellular phone	//
cent	/sent/
centimetre	/'senti,mi:tз/
centimetre, centimeter	//
central	/´sentrəl/
centre	/'sentə/
century	/'sentʃuri/
ceremony	/´seriməni/
certain	/'sə:tn/
certainly	/´sə:tnli/
certificate	/sə'tifikit/
chain	/tʃeɪn/
chair	/tʃeə/
chairman, chairwoman	/tʃeəmən, 'tʃeə,wumən/
challenge	/'tʃælindʤ/
chamber	/ˈtʃeɪmbər/
chance	/tʃæns , tʃɑ:ns/
change	/tʃeɪndʒ/
channel	/'tʃænl/
chapter	/'t∫æptə(r)/
character	/'kæriktə/
characteristic	/¸kærəktə´ristik/
charge	/tʃɑ:dʤ/
charity	/´tʃæriti/
chart	/tʃa:t/
chase	/tʃeis/
chat	/tʃæt/
cheap	/tʃi:p/
cheaply	//
cheat	/tʃit/
check	/tʃek/
cheek	/´tʃi:k/
cheerful	/´tʃiəful/
cheerfully	//
cheese	/tʃi:z/
chemical	/ˈkɛmɪkəl/
chemist	/´kemist/
chemist’s	//
chemistry	/´kemistri/
cheque	/t∫ek/
chest	/tʃest/
chew	/tʃu:/
chicken	/ˈtʃɪkin/
chief	/tʃi:f/
child	/tʃaild/
chin	/tʃin/
chip	/tʃip/
chocolate	/ˈtʃɒklɪt/
choice	/tʃɔɪs/
choose	/t∫u:z/
chop	/tʃɔp/
church	/tʃə:tʃ/
cigarette	/¸sigə´ret/
cinema	/ˈsɪnəmə/
circle	/'sə:kl/
circumstance	/ˈsɜrkəmˌstəns/
citizen	/´sitizən/
city	/'si:ti/
civil	/'sivl/
claim	/kleim/
clap	/klæp/
class	/klɑ:s/
classic	/'klæsik/
classroom	/'klα:si/
clean	/kli:n/
clear	//
clearly	/´kliəli/
clerk	/kla:k/
clever	/'klevə/
click	/klik/
client	/´klaiənt/
climate	/'klaimit/
climb	/klaim/
climbing	/´klaimiη/
clock	/klɔk/
close	/klouz/
closed	/klouzd/
closely	/´klousli/
closet	/'klozit/
cloth	/klɔθ/
clothes	/klouðz/
clothing	/´klouðiη/
cloud	/klaud/
club	/´klʌb/
coach	/koʊtʃ/
coal	/koul/
coast	/koust/
coat	/koʊt/
code	/koud/
coffee	/'kɔfi/
coin	/kɔin/
cold	/kould/
coldly	/'kouldli/
collapse	/kз'læps/
colleague	/ˈkɒlig/
collect	/kə´lekt/
collection	/kəˈlɛkʃən/
college	/'kɔlidʤ/
color, colour	/'kʌlə/
coloured	/´kʌləd/
column	/'kɔləm/
combination	/,kɔmbi'neiʃn/
combine	/'kɔmbain/
come	/kʌm/
comedy	/´kɔmidi/
comfort	/'kΔmfзt/
comfortable	/'kΔmfзtзbl/
comfortably	/´kʌmfətəbli/
command	/kə'mɑ:nd/
comment	/ˈkɒment/
commercial	/kə'mə:ʃl/
commission	/kəˈmɪʃən/
commit	/kə'mit/
commitment	/kə'mmənt/
committee	/kə'miti/
common	/'kɔmən/
commonly	/´kɔmənli/
communicate	/kə'mju:nikeit/
communication	/kə,mju:ni'keiʃn/
community	/kə'mju:niti/
company	/´kʌmpəni/
compare	/kәm'peә(r)/
comparison	/kəm'pærisn/
compete	/kəm'pi:t/
competition	/,kɔmpi'tiʃn/
competitive	/kəm´petitiv/
complain	/kəm´plein/
complaint	/kəmˈpleɪnt/
complete	/kəm'pli:t/
completely	/kзm'pli:tli/
complex	/'kɔmleks/
complicate	/'komplikeit/
complicated	/'komplikeitid/
computer	/kəm'pju:tə/
concentrate	/'kɔnsentreit/
concentration	/,kɒnsn'trei∫n/
concept	/ˈkɒnsept/
concern	/kәn'sз:n/
concerned	/kən´sə:nd/
concerning	/kən´sə:niη/
concert	/kən'sə:t/
conclude	/kənˈklud/
conclusion	/kənˈkluʒən/
concrete	/'kɔnkri:t/
condition	/kәn'di∫әn/
conduct	/kən'dʌkt/
conference	/ˈkɒnfrəns/
confidence	/'konfid(ә)ns/
confident	/'kɔnfidənt/
confidently	/'kɔnfidəntli/
confine	/kən'fain/
confined	/kən'faind/
confirm	/kən'fə:m/
conflict	/ˈkɒnflɪkt/
confront	/kən'frʌnt/
confuse	//
confused	/kən'fju:zd/
confusing	/kən'fju:ziη/
confusion	/kən'fju:ʒn/
congratulations	/kən,grætju'lei∫n/
congress	/'kɔɳgres/
connect	/kə'nekt/
connection	/kə´nekʃən,/
conscious	/ˈkɒnʃəs/
consequence	/'kɔnsikwəns/
conservative	/kən´sə:vətiv/
consider	/kən´sidə/
considerable	/kən'sidərəbl/
considerably	/kən'sidərəbly/
consideration	/kənsidə'reiʃn/
consist of	/kən'sist/
constant	/'kɔnstənt/
constantly	/'kɔnstəntli/
construct	/kən´strʌkt/
construction	/kən'strʌkʃn/
consult	/kən'sʌlt/
consumer	/kən'sju:mə/
contact	/ˈkɒntækt/
contain	/kәn'tein/
container	/kən'teinə/
contemporary	/kən'tempərəri/
content	/kən'tent/
contest	/kən´test/
context	/'kɔntekst/
continent	/'kɔntinənt/
continue	/kən´tinju:/
continuous	/kən'tinjuəs/
continuously	/kən'tinjuəsli/
contract	/'kɔntrækt/
contrast	/kən'træst/
contrasting	/kən'træsti/
contribute	/kən'tribju:t/
contribution	/¸kɔntri´bju:ʃən/
control	/kən'troul/
controlled	/kən'trould/
convenient	/kən´vi:njənt/
convention	/kən'ven∫n/
conventional	/kən'ven∫ənl/
conversation	/,kɔnvə'seiʃn/
convert	/kən'və:t/
convince	/kən'vins/
cook	/kʊk/
cooker	/´kukə/
cookie	/´kuki/
cooking	/kʊkiɳ/
cool	/ku:l/
cope (+ with)	/koup/
copy	/'kɔpi/
core	/kɔ:/
corner	/´kɔ:nə/
correct	/kə´rekt/
correctly	/kə´rektli/
cost	/kɔst , kɒst/
cottage	/'kɔtidʤ/
cotton	/ˈkɒtn/
cough	/kɔf/
coughing	/´kɔfiη/
could	/kud/
council	/kaunsl/
count	/kaunt/
counter	/ˈkaʊntər/
country	/ˈkʌntri/
countryside	/'kʌntri'said/
county	/koun'ti/
couple	/'kʌpl/
courage	/'kʌridʤ/
course	/kɔ:s/
court	/kɔrt , koʊrt/
cousin	/ˈkʌzən/
cover	/'kʌvə/
covered	/'kʌvərd/
covering	/´kʌvəriη/
cow	/kaʊ/
crack	/kræk/
cracked	/krækt/
craft	/kra:ft/
crash	/kræʃ/
crazy	/'kreizi/
cream	/kri:m/
create	/kri:'eit/
creature	/'kri:tʃə/
credit	/ˈkrɛdɪt/
credit card	//
crime	/kraim/
criminal	/ˈkrɪmənl/
crisis	/ˈkraɪsɪs/
crisp	/krips/
criterion	/kraɪˈtɪəriən/
critical	/ˈkrɪtɪkəl/
criticism	/´kriti¸sizəm/
criticize	/ˈkrɪtəˌsaɪz/
crop	/krop/
cross	/krɔs/
crowd	/kraud/
crowded	/kraudid/
crown	/kraun/
crucial	/´kru:ʃəl/
cruel	/'kru:ә(l)/
crush	/krᴧ∫/
cry	/krai/
cultural	/ˈkʌltʃərəl/
culture	/ˈkʌltʃər/
cup	/kʌp/
cupboard	/'kʌpbəd/
curb	/kə:b/
cure	/kjuə/
curious	/'kjuəriəs/
curiously	/'kjuəriəsli/
curl	/kə:l/
curly	/´kə:li/
current	/'kʌrənt/
currently	/'kʌrəntli/
curtain	/'kə:tn/
curve	/kə:v/
curved	/kə:vd/
custom	/'kʌstəm/
customer	/´kʌstəmə/
customs	/´kʌstəmz/
cut	/kʌt/
cycle	/'saikl/
cycling	/saikliŋ/
dad	/dæd/
daily	/'deili/
damage	/'dæmidʤ/
damp	/dæmp/
dance	/dɑ:ns/
dancer	/'dɑ:nsə/
dancing	/'dɑ:nsiɳ/
danger	/'deindʤə/
dangerous	/´deindʒərəs/
dare	/deər/
dark	/dɑ:k/
data	/´deitə/
date	/deit/
daughter	/ˈdɔtər/
day	/dei/
dead	/ded/
deaf	/def/
deal	/di:l/
dear	/diə/
death	/deθ/
debate	/dɪˈbeɪt/
debt	/det/
decade	/'dekeid/
decay	/di'kei/
December (abbr Dec)	/di'sembə/
decide	/di'said/
decision	/diˈsiʒn/
declare	/di'kleə/
decline	/di'klain/
decorate	/´dekə¸reit/
decoration	/¸dekə´reiʃən/
decorative	/´dekərətiv/
decrease	/'di:kri:s/
deep	/di:p/
deeply	/´di:pli/
defeat	/di'fi:t/
defence	/di'fens/
defend	/di'fend/
define	/di'fain/
definite	/dә'finit/
definitely	/'definitli/
definition	/defini∫n/
degree	/dɪˈgri:/
delay	/dɪˈleɪ/
deliberate	/di'libәreit/
deliberately	/di´libəritli/
delicate	/'delikeit/
delight	/di'lait/
delighted	/di'laitid/
deliver	/di'livə/
delivery	/di'livəri/
demand	/dɪ.ˈmænd/
demonstrate	/ˈdɛmənˌstreɪt/
dentist	/'dentist/
deny	/di'nai/
department	/di'pɑ:tmənt/
departure	/di'pɑ:tʃə/
depend	/di'pend/
deposit	/dɪˈpɒzɪt/
depress	/di´pres/
depressed	/di-'prest/
depressing	/di'presiη/
depth	/depθ/
derive	/di´raiv/
describe	/dɪˈskraɪb/
description	/dɪˈskrɪpʃən/
desert	/ˈdɛzərt/
deserted	/di'zз:tid/
deserve	/di'zз:v/
design	/di´zain/
desire	/di'zaiə/
desk	/desk/
desperate	/'despərit/
desperately	/'despəritli/
despite	/dis'pait/
destroy	/dis'trɔi/
destruction	/dis'trʌk∫n/
detail	/(n) ˈditeɪl ; (v) dɪˈteɪl/
detailed	/'di:teild/
determination	/di,tə:mi'neiʃn/
determine	/di'tз:min/
determined	/di´tə:mind/
develop	/di'veləp/
development	/di’velәpmәnt/
device	/di'vais/
devote	/di'vout/
devoted	/di´voutid/
diagram	/ˈdaɪəˌgræm/
diamond	/´daiəmənd/
diary	/'daiəri/
dictionary	/'dikʃənəri/
die	/daɪ/
diet	/'daiət/
difference	/ˈdɪfərəns , ˈdɪfrəns/
different	/'difrзnt/
differently	/'difrзntli/
difficult	/'difik(ə)lt/
difficulty	/'difikəlti/
dig	/dɪg/
dinner	/'dinə/
direct	/di'rekt; dai'rekt/
direction	/di'rek∫n/
directly	/dai´rektli/
director	/di'rektə/
dirt	/də:t/
dirty	/´də:ti/
disabled	/dis´eibld/
disadvantage	/dɪsədˈvɑntɪdʒ/
disagree	/¸disə´gri:/
disagreement	/¸disəg´ri:mənt/
disappear	/disə'piə/
disappoint	/ˌdɪsəˈpɔɪnt/
disappointed	/,disз'pointid/
disappointing	/¸disə´pɔintiη/
disappointment	/¸disə´pɔintmənt/
disapproval	/¸disə´pru:vl/
disapprove	/¸disə´pru:v/
disapproving	/¸disə´pru:viη/
disaster	/di'zɑ:stə/
disc, disk	/disk/
discipline	/'disiplin/
discount	/'diskaunt/
discover	/dis'kʌvə/
discovery	/dis'kʌvəri/
discuss	/dis'kΛs/
discussion	/dis'kʌʃn/
disease	/di'zi:z/
disgust	/dis´gʌst/
disgusted	/dis´gʌstid/
disgusting	/dis´gʌstiη/
dish	/diʃ/
dishonest	/dis´ɔnist/
dishonestly	/dis'onistli/
disk	/disk/
dislike	/dis'laik/
dismiss	/dis'mis/
display	/dis'plei/
dissolve	/dɪˈzɒlv/
distance	/'distəns/
distinguish	/dis´tiηgwiʃ/
distribute	/dis'tribju:t/
distribution	/,distri'bju:ʃn/
district	/'distrikt/
disturb	/dis´tə:b/
disturbing	/dis´tə:biη/
divide	/di'vaid/
division	/dɪ'vɪʒn/
divorce	/di´vɔ:s/
divorced	/di'vo:sd/
do	/du:, du/
doctor (abbr Dr)	/'dɔktə/
document	/'dɒkjʊmənt/
dog	/dɔg/
dollar	/´dɔlə/
domestic	/də'mestik/
dominate	/ˈdɒməˌneɪt/
door	/dɔ:/
dot	/dɔt/
double	/'dʌbl/
doubt	/daut/
down	/daun/
downstairs	/daun'steзz/
downward	/´daun¸wəd/
downwards	/´daun¸wədz/
dozen	/dʌzn/
draft	/dra:ft/
drag	/drӕg/
drama	/drɑː.mə/
dramatic	/drə´mætik/
dramatically	/drə'mætikəli/
draw	/dro:/
drawer	/´drɔ:ə/
drawing	/'dro:iŋ/
dream	/dri:m/
dress	/dres/
dressed	//
drink	/driɳk/
drive	/draiv/
driver	/draivә(r)/
driving	/'draiviɳ/
drop	/drɒp/
drug	/drʌg/
drugstore	/'drʌgstɔ:/
drum	/drʌm/
drunk	/drʌŋk/
dry	/drai/
due	/du, dyu/
dull	/dʌl/
dump	/dʌmp/
during	/'djuəriɳ/
dust	/dʌst/
duty	/'dju:ti/
DVD	//
dying	/ˈdaɪɪŋ/
e.g.	//
each	/i:tʃ/
each other	//
each other	//
ear	/iə/
early	/´ə:li/
earn	/ə:n/
earth	/ə:θ/
ease	/i:z/
easily	/'i:zili/
east	/i:st/
eastern	/'i:stən/
easy	/'i:zi/
eat	/i:t/
economic	/¸i:kə´nɔmik/
economy	/ɪˈkɒnəmi/
edge	/edӡ/
edition	/i'diʃn/
editor	/´editə/
educate	/'edju:keit/
educated	/'edju:keitid/
education	/,edju:'keiʃn/
effect	/i'fekt/
effective	/'ifektiv/
effectively	/i'fektivli/
efficient	/i'fiʃənt/
efficiently	/i'fiʃəntli/
effort	/´efə:t/
egg	/eg/
either	/´aiðə/
elbow	/elbou/
elderly	/´eldəli/
elect	/i´lekt/
election	/i´lekʃən/
electric	/ɪˈlɛktrɪk/
electrical	/i'lektrikəl/
electricity	/ilek'trisiti/
electronic	/ɪlɛkˈtrɒnɪk , ˌilɛkˈtrɒnɪk/
elegant	/´eligənt/
element	/ˈɛləmənt/
elevator	/ˈɛləˌveɪtər/
else	/els/
elsewhere	/¸els´wɛə/
email, e-mail	/'imeil/
embarrass	/im´bærəs/
embarrassed	/im´bærəst/
embarrassing	/im´bærəsiη/
embarrassment	/im´bærəsmənt/
emerge	/i´mə:dʒ/
emergency	/i'mз:dЗensi/
emotion	/i'moƱʃ(ә)n/
emotional	/i´mouʃənəl/
emotionally	/i´mouʃənəli/
emphasis	/´emfəsis/
emphasize	/ˈɛmfəˌsaɪz/
empire	/'empaiə/
employ	/im'plɔi/
employee	/¸emplɔi´i:/
employer	/em´plɔiə/
employment	/im'plɔimənt/
empty	/'empti/
enable	/i'neibl/
encounter	/in'kautә/
encourage	/in'kΔridЗ/
encouragement	/in´kʌridʒmənt/
end	/end/
ending	/´endiη/
enemy	/'enәmi/
energy	/ˈɛnərdʒi/
engage	/in'geidʤ/
engaged	/in´geidʒd/
engine	/en'ʤin/
engineer	/endʒi'niər/
engineering	/,enʤɪ'nɪərɪŋ/
enjoy	/in'dЗoi/
enjoyable	/in´dʒɔiəbl/
enjoyment	/in´dʒɔimənt/
enormous	/i'nɔ:məs/
enough	/i'nʌf/
enquiry	/in'kwaiәri/
ensure	/ɛnˈʃʊər , ɛnˈʃɜr/
enter	/´entə/
entertain	/,entə'tein/
entertainer	/¸entə´teinə/
entertaining	/,entə'teiniɳ/
entertainment	/entə'teinm(ə)nt/
enthusiasm	/ɛnˈθuziˌæzəm/
enthusiastic	/ɛnˌθuziˈæstɪk/
entire	/in'taiə/
entirely	/in´taiəli/
entitle	/in'taitl/
entrance	/'entrəns/
entry	/ˈɛntri/
envelope	/'enviloup/
environment	/in'vaiərənmənt/
environmental	/in,vairən'mentl/
equal	/´i:kwəl/
equally	/'i:kwзli/
equipment	/i'kwipmənt/
equivalent	/i´kwivələnt/
error	/'erə/
escape	/is'keip/
especially	/is'peʃəli/
essay	/ˈɛseɪ/
essential	/əˈsɛnʃəl/
essentially	/e¸senʃi´əli/
establish	/ɪˈstæblɪʃ/
estate	/ɪˈsteɪt/
estimate	/'estimit - 'estimeit/
etc., et cetera	/et setərə/
euro	/´ju:rou/
even	/'i:vn/
evening	/'i:vniɳ/
event	/i'vent/
eventually	/i´ventjuəli/
ever	/'evә(r)/
every	/'evәri/
everyone, everybody	/´evri¸wʌn/
everything	/'evriθiɳ/
everywhere	/´evri¸weə/
evidence	/'evidəns/
evil	/'i:vl/
ex-	//
exact	/ig´zækt/
exactly	/ig´zæktli/
exaggerate	/ig´zædʒə¸reit/
exaggerated	/ig'zædЗзreit/
exam	/ig´zæm/
examination	/ig¸zæmi´neiʃən/
examine	/ɪgˈzæmɪn/
example	/ig´za:mp(ə)l/
excellent	/ˈeksələnt/
except	/ik'sept/
exception	/ik'sepʃn/
exchange	/iks´tʃeindʒ/
excite	/ik'sait/
excited	/ɪkˈsaɪtɪd/
excitement	/ik´saitmənt/
exciting	/ik´saitiη/
exclude	/iks´klu:d/
excluding	/iks´klu:diη/
excuse	/iks´kju:z/
executive	/ɪgˈzɛkyətɪv/
exercise	/'eksəsaiz/
exhibit	/ɪgˈzɪbɪt/
exhibition	/ˌɛksəˈbɪʃən/
exist	/ig'zist/
existence	/ig'zistəns/
exit	/´egzit/
expand	/iks'pænd/
expect	/ik'spekt/
expectation	/,ekspek'tei∫n/
expected	/iks´pektid/
expense	/ɪkˈspɛns/
expensive	/iks'pensiv/
experience	/iks'piəriəns/
experienced	/eks´piəriənst/
experiment	/(n)ɪkˈspɛrəmənt/
expert	/,ekspз'ti:z/
explain	/iks'plein/
explanation	/,eksplə'neiʃn/
explode	/iks'ploud/
explore	/iks´plɔ:/
explosion	/iks'plouʤn/
export	/iks´pɔ:t/
expose	/ɪkˈspoʊz/
express	/iks'pres/
expression	/iks'preʃn/
extend	/iks'tend/
extension	/ɪkstent ʃən/
extensive	/iks´tensiv/
extent	/ɪkˈstɛnt/
extra	/'ekstrə/
extraordinary	/iks'trɔ:dnri/
extreme	/iks'tri:m/
extremely	/iks´tri:mli/
eye	/ai/
face	/feis/
facility	/fəˈsɪlɪti/
fact	/fækt/
factor	/'fæktə/
factory	/'fæktəri/
fail	/feil/
failure	/ˈfeɪlyər/
faint	/feɪnt/
faintly	/'feintli/
fair	/feə/
fairly	/'feəli/
faith	/feiθ/
faithful	/'feiθful/
faithfully	/'feiθfuli/
fall	/fɔl/
false	/fo:ls/
fame	/feim/
familiar	/fəˈmiliər/
family	/ˈfæmili/
famous	/'feiməs/
fan	/fæn/
fancy	/ˈfænsi/
far	/fɑ:/
farm	/fa:m/
farmer	/'fɑ:mə(r)/
farming	/'fɑ:miɳ/
fashion	/'fæ∫ən/
fashionable	/'fæʃnəbl/
fast	/fa:st/
fasten	/'fɑ:sn/
fat	/fæt/
father	/'fɑ:ðə/
faucet	/ˈfɔsɪt/
fault	/fɔ:lt/
favour	/'feivз/
favourite	/'feivзrit/
fear	/fɪər/
feather	/'feðə/
feature	/'fi:tʃə/
February (abbr Feb)	/´februəri/
federal	/'fedərəl/
fee	/fi:/
feed	/fid/
feel	/fi:l/
feel sick	//
feeling	/'fi:liɳ/
fellow	/'felou/
female	/´fi:meil/
fence	/fens/
festival	/'festivəl/
fetch	/fetʃ/
fever	/'fi:və/
few	/fju:/
field	/fi:ld/
fight	/fait/
fighting	/´faitiη/
figure	/figә(r)/
file	/fail/
fill	/fil/
film	/film/
final	/'fainl/
finally	/´fainəli/
finance	/fɪˈnæns , ˈfaɪnæns/
financial	/fai'næn∫l/
find	/faind/
fine	/fain/
finely	/´fainli/
finger	/'fiɳgə/
finish	//
finished	/ˈfɪnɪʃt/
fire	/'faiə/
firm	/'fə:m/
firmly	/´fə:mli/
first	/fə:st/
fish	/fɪʃ/
fishing	/´fiʃiη/
fit	/fit/
fix	/fiks/
fixed	//
flag	/'flæg/
flame	/fleim/
flash	/flæ∫/
flat	/flæt/
flavour	/'fleivə/
flesh	/fle∫/
flight	/flait/
float	/floʊt/
flood	/flʌd/
floor	/flɔ:/
flour	/´flauə/
flow	/flow/
flower	/'flauə/
flu	/flu:/
fly	/flaɪ/
flying	/´flaiiη/
focus	/'foukəs/
fold	/foʊld/
folding	/´fouldiη/
follow	/'fɔlou/
following	/´fɔlouiη/
food	/fu:d/
foot	/fut/
football	/ˈfʊtˌbɔl/
for	/fɔ:,fə/
force	/fɔ:s/
forecast	/fɔ:'kɑ:st/
foreign	/'fɔrin/
forest	/'forist/
forever	/fə'revə/
forget	/fə'get/
forgive	/fərˈgɪv/
fork	/fɔrk/
form	/fɔ:m/
formal	/fɔ:ml/
formally	/fo:mзlaiz/
former	/´fɔ:mə/
formerly	/´fɔ:məli/
formula	/'fɔ:mjulə/
fortune	/ˈfɔrtʃən/
forward	/ˈfɔrwərd/
forward, forwards	/ˈfɔrwərd/
found	/faund/
foundation	/faun'dei∫n/
frame	/freim/
free	/fri:/
freedom	/'fri:dəm/
freely	/´fri:li/
freeze	/fri:z/
frequent	/ˈfrikwənt/
frequently	/´fri:kwəntli/
fresh	/freʃ/
freshly	/´freʃli/
Friday (abbr Fri)	/´fraidi/
fridge	/fridЗ/
friend	/frend/
friendly	/´frendli/
friendship	/'frendʃipn/
frighten	/ˈfraɪtn/
frightened	/'fraitnd/
frightening	/´fraiəniη/
from	/frɔm/
front	/frʌnt/
frozen	/frouzn/
fruit	/fru:t/
fry	/frai/
fuel	/ˈfyuəl/
full	/ful/
fully	/´fuli/
fun	/fʌn/
function	/ˈfʌŋkʃən/
fund	/fʌnd/
fundamental	/,fʌndə'mentl/
funeral	/ˈfju:nərəl/
funny	/´fʌni/
fur	/fə:/
furniture	/'fə:nitʃə/
further	/'fə:ðə/
further, furthest	//
future	/'fju:tʃə/
gain	/geɪn/
gallon	/'gælən/
gamble	/'gæmbl/
gambling	/'gæmbliɳ/
game	/geim/
gap	/gæp/
garage	/´gæra:ʒ/
garbage	/ˈgɑrbɪdʒ/
garden	/'gɑ:dn/
gas	/gæs/
gasoline	/gasolin/
gate	/geit/
gather	/'gæðə/
gear	/giə/
general	/'ʤenər(ə)l/
generally	/'dʒenərəli/
generate	/'dʒenəreit/
generation	/ˌdʒɛnəˈreɪʃən/
generous	/´dʒenərəs/
generously	/'dʒenərəsli/
gentle	/dʒentl/
gentleman	/ˈdʒɛntlmən/
gently	/'dʤentli/
genuine	/´dʒenjuin/
genuinely	/´dʒenjuinli/
geography	/dʒi´ɔgrəfi/
get	/get/
giant	/ˈdʒaiənt/
gift	/gift/
girl	/g3:l/
girlfriend	/'gз:lfrend/
give	/giv/
give birth	//
glad	/glæd/
glass	/glɑ:s/
glasses	//
global	/´gloubl/
glove	/glʌv/
glue	/glu:/
go	/gou/
goal	/goƱl/
god	/gɒd/
gold	/goʊld/
good	/gud/
good, well	/gud, wel/
goodbye	/¸gud´bai/
goods	/gudz/
govern	/´gʌvən/
government	/ˈgʌvərnmənt , ˈgʌvərmənt/
governor	/´gʌvənə/
grab	/græb/
grade	/greɪd/
gradual	/´grædjuəl/
gradually	/'grædzuәli/
grain	/grein/
gram	/'græm/
gram, gramme (abbr g, gm)	/'græm/
grammar	/ˈgræmər/
grand	/grænd/
grandchild	/´græn¸tʃaild/
granddaughter	/'græn,do:tз/
grandfather	/´græn¸fa:ðə/
grandmother	/'græn,mʌðə/
grandparent	/´græn¸pɛərənts/
grandson	/´grænsʌn/
grant	/grα:nt/
grass	/grɑ:s/
grateful	/´greitful/
grave	/greiv/
gray	/grei/
great	/greɪt/
greatly	/´greitli/
green	/grin/
grey	/grei/
grey, usually gray	//
groceries	/ˈgroʊsəri, ˈgroʊsri/
grocery	/´grousəri/
ground	/graund/
group	/gru:p/
grow	/grou/
growth	/grouθ/
guarantee	/ˌgærənˈti/
guard	/ga:d/
guess	/ges/
guest	/gest/
guide	/gaɪd/
guilty	/ˈgɪlti/
gun	/gʌn/
guy	/gai/
habit	/´hæbit/
hair	/heə/
hairdresser	/'heədresə/
half	/hɑ:f/
hall	/hɔ:l/
hammer	/'hæmə/
hand	/hænd/
handle	/'hændl/
hang	/hæŋ/
happen	/'hæpən/
happily	/'hæpili/
happiness	/'hæpinis/
happy	/ˈhæpi/
hard	/ha:d/
hardly	/´ha:dli/
harm	/hɑ:m/
harmful	/´ha:mful/
harmless	/´ha:mlis/
hat	/hæt/
hate	/heit/
hatred	/'heitrid/
have	/hæv, həv/
have to	//
he	/hi:/
head	/hed/
headache	/'hedeik/
heal	/hi:l/
health	/hɛlθ/
healthy	/'helθi/
hear	/hiə/
hearing	/ˈhɪərɪŋ/
heart	/hɑ:t/
heat	/hi:t/
heating	/'hi:tiη/
heaven	/ˈhɛvən/
heavily	/´hevili/
heavy	/'hevi/
heel	/hi:l/
height	/hait/
hell	/hel/
hello	/hз'lou/
help	/'help/
helpful	/´helpful/
hence	/hens/
her	/hз:/
here	/hiə/
hero	/'hiərou/
hers	/hə:z/
herself	/hə:´self/
hesitate	/'heziteit/
hi	/hai/
hide	/haid/
high	/hai/
highlight	/ˈhaɪˌlaɪt/
highly	/´haili/
highway	/´haiwei/
hill	/hil/
him	/him/
himself	/him´self/
hip	/hip/
hire	/haiə/
his	/hiz/
historical	/his'tɔrikəl/
history	/´histəri/
hit	/hit/
hobby	/'hɒbi/
hold	/hould/
hole	/'houl/
holiday	/'hɔlədi/
hollow	/'hɔlou/
holy	/ˈhoʊli/
home	/hoʊm/
homework	/´houm¸wə:k/
honest	/'ɔnist/
honestly	/'ɔnistli/
honour	/'onз/
hook	/huk/
hope	/houp/
horizontal	/,hɔri'zɔntl/
horn	/hɔ:n/
horror	/´hɔrə/
horse	/hɔrs/
hospital	/'hɔspitl/
host	/houst/
hot	/hɒt/
hotel	/hou´tel/
hour	/auз/
house	/haus/
household	/´haushould/
housing	/´hauziη/
how	/hau/
however	/hau´evə/
huge	/hjuːdʒ/
human	/'hju:mən/
humorous	/´hju:mərəs/
humour	/´hju:mə/
hungry	/'hΔŋgri/
hunt	/hʌnt/
hunting	/'hʌntiɳ/
hurry	/ˈhɜri , ˈhʌri/
hurt	/hɜrt/
husband	/´hʌzbənd/
i.e.	//
ice	/ais/
ice cream	//
idea	/ai'diз/
ideal	/aɪˈdiəl, aɪˈdil/
ideally	/aɪˈdiəli/
identify	/ai'dentifai/
identity	/aɪˈdɛntɪti/
if	/if/
ignore	/ig'no:(r)/
ill	/il/
illegal	/i´li:gl/
illegally	/i´li:gəli/
illness	/´ilnis/
illustrate	/´ilə¸streit/
image	/´imidʒ/
imaginary	/i´mædʒinəri/
imagination	/i,mædʤi'neiʃn/
imagine	/i'mæʤin/
immediate	/i'mi:djət/
immediately	/i'mi:djətli/
immoral	/i´mɔrəl/
impact	/ˈɪmpækt/
impatient	/im'peiʃən/
impatiently	/im'pei∫зns/
implication	/¸impli´keiʃən/
imply	/im'plai/
import	//
importance	/im'pɔ:təns/
important	/im'pɔ:tənt/
importantly	/im'pɔ:təntli/
impose	/im'pouz/
impossible	/im'pɔsəbl/
impress	/im'pres/
impressed	//
impression	/ɪmˈprɛʃən/
impressive	/im'presiv/
improve	/im'pru:v/
improvement	/im'pru:vmənt/
in	/in/
in addition	//
in case of	//
in control of	//
in exchange for	//
inability	/¸inə´biliti/
inch	/intʃ/
incident	/´insidənt/
include	/in'klu:d/
including	/in´klu:diη/
income	/'inkəm/
increase	/in'kri:s/
increasingly	/in´kri:siηli/
indeed	/ɪnˈdid/
independence	/,indi'pendəns/
independent	/,indi'pendənt/
independently	/,indi'pendзntli/
index	/'indeks/
indicate	/´indikeit/
indication	/,indi'kei∫n/
indirect	/¸indi´rekt/
indirectly	/,indi'rektli/
individual	/indivídʤuəl/
indoor	/´in¸dɔ:/
indoors	/¸in´dɔ:z/
industrial	/in´dʌstriəl/
industry	/'indəstri/
inevitable	/in´evitəbl/
inevitably	/in’evitəbli/
infect	/in'fekt/
infected	//
infection	/in'fekʃn/
infectious	/in´fekʃəs/
influence	/ˈɪnfluəns/
inform	/in'fo:m/
informal	/in´fɔ:məl/
information	/,infə'meinʃn/
ingredient	/in'gri:diәnt/
initial	/i'ni∫зl/
initially	/i´niʃəli/
initiative	/ɪˈnɪʃiətɪv , ɪˈnɪʃətɪv/
injure	/in'dӡә(r)/
injured	/´indʒə:d/
injury	/'indʤəri/
ink	/iηk/
inner	/'inə/
innocent	/'inəsnt/
insect	/'insekt/
insert	/'insə:t/
inside	/'in'said/
insist	/in'sist/
install	/in'stɔ:l/
instance	/'instəns/
instead	/in'sted/
institute	/ˈ´institju:t/
institution	/insti'tju:ʃn/
instruction	/ɪn'strʌkʃn/
instrument	/'instrumənt/
insult	/'insʌlt/
insulting	/in´sʌltiη/
insurance	/in'ʃuərəns/
intelligence	/in'telidʒəns/
intelligent	/in,teli'dЗen∫зl/
intend	/in'tend/
intended	/in´tendid/
intention	/in'tenʃn/
interest	/ˈɪntərest/
interested	//
interesting	/'intristiŋ/
interior	/in'teriə/
internal	/in'tə:nl/
international	/intə'næʃən(ə)l/
internet	/'intə,net/
interpret	/in'tз:prit/
interpretation	/in,tə:pri'teiʃn/
interrupt	/ɪntǝ'rʌpt/
interruption	/,intə'rʌp∫n/
interval	/ˈɪntərvəl/
interview	/'intəvju:/
into	/'intu/
introduce	/'intrədju:s/
introduction	/¸intrə´dʌkʃən/
invent	/in'vent/
invention	/ɪnˈvɛnʃən/
invest	/in'vest/
investigate	/in'vestigeit/
investigation	/in¸vesti´geiʃən/
investment	/in'vestmənt/
invitation	/,invi'teiʃn/
invite	/in'vait/
involve	/ɪnˈvɒlv/
involvement	/in'vɔlvmənt/
iron	/aɪən/
irritate	/´iri¸teit/
irritated	/'iriteitid/
irritating	/´iriteitiη/
island	/´ailənd/
issue	/ɪʃuː; also ɪsjuː/
it	/it/
item	/'aitəm/
its	/its/
itself	/it´self/
jacket	/'dʤækit/
jam	/dʒæm/
January (abbrJan)	/'ʤænjuəri/
jealous	/'ʤeləs/
jeans	/dЗeins/
jelly	/´dʒeli/
jewellery	/'dʤu:əlri/
job	/dʒɔb/
join	/ʤɔin/
joint	/dʒɔɪnt/
jointly	/ˈdʒɔɪntli/
joke	/dʒouk/
journalist	/´dʒə:nəlist/
journey	/'dʤə:ni/
joy	/dʒɔɪ/
judge	/dʒʌdʒ/
judgement	/'dʤʌdʤmənt/
juice	/ʤu:s/
July (abbr Jul)	/dʒu´lai/
jump	/dʒʌmp/
June (abbr Jun)	/dЗu:n/
junior	/´dʒu:niə/
just	/dʤʌst/
justice	/'dʤʌstis/
justified	/'dʒʌstɪfaɪd/
justify	/´dʒʌsti¸fai/
keen	/ki:n/
keep	/ki:p/
key	/ki:/
keyboard	/'ki:bɔ:d/
kick	/kick/
kid	/kid/
kill	/kil/
killing	/´kiliη/
kilogram, kilogramme, kilo (abbr kg)	/´kilou¸græm/
kilometre	/´kilə¸mi:tə/
kilometre, kilometer (abbr k, km)	/´kilə¸mi:tə/
kind	/kaind/
kindly	/´kaindli/
kindness	/'kaindnis/
king	/kiɳ/
kiss	/kis/
kitchen	/´kitʃin/
knee	/ni:/
knife	/naif/
knit	/nit/
knitted	/nitid/
knitting	/´nitiη/
knock	/nɔk/
knot	/nɔt/
know	/nou/
knowledge	/'nɒliʤ/
label	/leibl/
laboratory, lab	/ˈlæbrəˌtɔri/
labour	/'leibз/
lack	/læk/
lacking	/'lækiη/
lady	/ˈleɪdi/
lake	/leik/
lamp	/læmp/
land	/lænd/
landscape	/'lændskeip/
lane	/lein/
language	/ˈlæŋgwɪdʒ/
large	/la:dʒ/
largely	/´la:dʒli/
last	/lɑ:st/
late	/leit/
later	/leɪtə(r)/
latest	/leitist/
latter	/´lætə/
laugh	/lɑ:f/
launch	/lɔ:ntʃ/
law	/lo:/
lawyer	/ˈlɔyər , ˈlɔɪər/
lay	/lei/
layer	/'leiə/
lazy	/'leizi/
lead	/li:d/
leader	/´li:də/
leading	/´li:diη/
leaf	/li:f/
league	/li:g/
lean	/li:n/
learn	/lə:n/
least	/li:st/
leather	/'leðə/
leave	/li:v/
lecture	/'lekt∫ә(r)/
left	/left/
leg	/´leg/
legal	/ˈligəl/
legally	/'li:gзlizm/
lemon	/´lemən/
lend	/lend/
length	/leɳθ/
less	/les/
lesson	/'lesn/
let	/lεt/
letter	/'letə/
level	/'levl/
library	/'laibrəri/
licence	/ˈlaɪsəns/
license	/laisзns/
lid	/lid/
lie	/lai/
life	/laif/
lift	/lift/
light	/lait/
lightly	/´laitli/
like	/laik/
likely	/´laikli/
limit	/'limit/
limited	/ˈlɪmɪtɪd/
line	/lain/
link	/lɪɳk/
lip	/lip/
liquid	/'likwid/
list	/list/
listen	/'lisn/
literature	/ˈlɪtərətʃər/
litre	/´li:tə/
little	/'lit(ә)l/
live	/liv/
lively	/'laivli/
living	/'liviŋ/
load	/loud/
loan	/ləʊn/
local	/'ləʊk(ə)l/
locally	/ˈloʊkəli/
locate	/loʊˈkeɪt/
located	/loʊˈkeɪtid/
location	/louk´eiʃən/
lock	/lɔk/
logic	/'lɔdʤik/
logical	/'lɔdʤikəl/
lonely	/´lounli/
long	/lɔɳ/
look	/luk/
look after	//
loose	/lu:s/
loosely	/´lu:sli/
lord	/lɔrd/
lorry	/´lɔ:ri/
lose	/lu:z/
loss	/lɔs , lɒs/
lost	/lost/
lot, a lot	/lɒt/
loud	/laud/
loudly	/'laudili/
love	/lʌv/
lovely	/ˈlʌvli/
lover	/´lʌvə/
low	/lou/
loyal	/'lɔiəl/
luck	/lʌk/
lucky	/'lʌki/
luggage	/'lʌgiʤ/
lump	/lΛmp/
lunch	/lʌntʃ/
lung	/lʌη/
machine	/mə'ʃi:n/
machinery	/mə'ʃi:nəri/
mad	/mæd/
magazine	/,mægə'zi:n/
magic	/'mæʤik/
mail	/meil/
main	/mein/
mainly	/´meinli/
maintain	/mein´tein/
major	/ˈmeɪdʒər/
majority	/mə'dʒɔriti/
make	/meik/
make friends with	//
make-up	/´meik¸ʌp/
male	/meil/
mall	/mɔ:l/
man	/mæn/
manage	/'mæniʤ/
management	/'mænidʒmənt/
manager	/ˈmænɪdʒər/
manner	/'mænз/
manufacture	/,mænju'fæktʃə/
manufacturer	/¸mæni´fæktʃərə/
manufacturing	/¸mænju´fæktʃəriη/
many	/'meni/
map	/mæp/
March (abbr Mar)	/mɑ:tʃ/
mark	/mɑ:k/
market	/'mɑ:kit/
marketing	/'mα:kitiη/
marriage	/ˈmærɪdʒ/
married	/´mærid/
marry	/'mæri/
mass	/mæs/
massive	/'mæsiv/
master	/'mɑ:stə/
match	/mætʃ/
matching	/´mætʃiη/
mate	/meit/
material	/mə´tiəriəl/
mathematics, also maths	/,mæθi'mætiks/
matter	/'mætə/
maximum	/´mæksiməm/
may	/mei/
May	/mei/
maybe	/´mei¸bi:/
mayor	/mɛə/
me	/mi:/
meal	/mi:l/
mean	/mi:n/
meaning	/'mi:niɳ/
means	/mi:nz/
meanwhile	/miː(n)waɪl/
measure	/'meʤə/
measurement	/'məʤəmənt/
meat	/mi:t/
media	/´mi:diə/
medical	/'medikə/
medicine	/'medisn/
medium	/'mi:djəm/
meet	/mi:t/
meeting	/'mi:tiɳ/
melt	/mɛlt/
member	/'membə/
membership	/'membəʃip/
memory	/'meməri/
mental	/'mentl/
mentally	/´mentəli/
mention	/'menʃn/
menu	/'menju/
mere	/miə/
merely	/'miәli/
mess	/mes/
message	/ˈmɛsɪdʒ/
metal	/'metl/
method	/'meθəd/
metre	/´mi:tə/
mid-	//
midday	/´mid´dei/
middle	/'midl/
midnight	/'midnait/
might	/mait/
mild	/maɪld/
mile	/mail/
military	/'militəri/
milk	/milk/
milligram, milligramme (abbr mg)	/´mili¸græm/
millimetre, millimeter (abbr mm)	/´mili¸mi:tə/
mind	/maid/
mine	//
mineral	/ˈmɪnərəl , ˈmɪnrəl/
minimum	/'miniməm/
minister	/´ministə/
ministry	/´ministri/
minor	/´mainə/
minority	/mai´nɔriti/
minute	/'minit/
mirror	/ˈmɪrər/
miss	/mis/
missing	/´misiη/
mistake	/mis'teik/
mistaken	/mis´teiken/
mix	/miks/
mixed	/mikst/
mixture	/ˈmɪkstʃər/
mobile	/'məʊbail; 'məʊbi:l/
mobile phone (mobile)	//
model	/ˈmɒdl/
modern	/'mɔdən/
moment	/'məum(ə)nt/
Monday (abbr Mon)	/'mʌndi/
money	/'mʌni/
monitor	/'mɔnitə/
month	/mʌnθ/
mood	/mu:d/
moon	/mu:n/
moral	/ˈmɔrəl , ˈmɒrəl/
morally	//
more	/mɔ:/
moreover	/mɔ:´rouvə/
morning	/'mɔ:niɳ/
most	/moust/
mostly	/´moustli/
mother	/'mΔðз/
motion	/´mouʃən/
motor	/´moutə/
motorcycle	/'moutə,saikl/
mount	/maunt/
mountain	/ˈmaʊntən/
mouse	/maus - mauz/
mouth	/mauθ - mauð/
move	/mu:v/
movement	/'mu:vmənt/
movie	/´mu:vi/
movie theater	//
moving	/'mu:viɳ/
Mr	//
Mrs	//
Ms	//
much	/mʌtʃ/
mud	/mʌd/
multiply	/'mʌltiplai/
mum	/mʌm/
murder	/'mə:də/
muscle	/'mʌsl/
museum	/mju:´ziəm/
music	/'mju:zik/
musical	/ˈmyuzɪkəl/
musician	/mju:'ziʃn/
must	/mʌst/
my	/mai/
myself	/mai'self/
mysterious	/mis'tiəriəs/
mystery	/'mistəri/
nail	/neil/
naked	/'neikid/
name	/neim/
narrow	/'nærou/
nation	/'nei∫n/
national	/'næʃən(ə)l/
natural	/'nætʃrəl/
naturally	/'næt∫rəli/
nature	/'neitʃə/
navy	/'neivi/
near	/niə/
nearby	/´niə¸bai/
nearly	/´niəli/
neat	/ni:t/
neatly	/ni:tli/
necessarily	/´nesisərili/
necessary	/'nesəseri/
neck	/nek/
need	/ni:d/
needle	/´ni:dl/
negative	/´negətiv/
neighbour	/'neibə/
neighbourhood	/´neibəhud/
neither	/'naiðə/
nephew	/´nevju:/
nerve	/nɜrv/
nervous	/ˈnɜrvəs/
nervously	/'nз:vзstli/
nest	/nest/
net	/net/
network	/'netwə:k/
never	/'nevə/
nevertheless	/,nevəðə'les/
new	/nju:/
newly	/´nju:li/
news	/nju:z/
newspaper	/'nju:zpeipə/
next	/nekst/
nice	/nais/
nicely	/´naisli/
niece	/ni:s/
night	/nait/
no	/nou/
nobody (noone)	/'noubədi/
noise	/nɔiz/
noisily	/´nɔizili/
noisy	/´nɔizi/
non-	//
none	/nʌn/
nonsense	/´nɔnsəns/
nor	/no:/
normal	/'nɔ:məl/
normally	/'no:mзli/
north	/nɔ:θ/
northern	/'nɔ:ðən/
nose	/nouz/
not	/nɔt/
note	/nout/
nothing	/ˈnʌθɪŋ/
notice	/'nәƱtis/
noticeable	/ˈnoʊtɪsəbəl/
novel	/ˈnɒvəl/
November (abbr Nov)	/nou´vembə/
now	/nau/
nowhere	/´nou¸wɛə/
nuclear	/'nju:kliз/
number (abbr No)	/´nʌmbə/
nurse	/nə:s/
nut	/nʌt/
o clock	/klɔk/
obey	/o'bei/
object	/(n) ˈɒbdʒɛkt ; (v) əbˈdʒɛkt/
objective	/əb´dʒektiv/
observation	/obzә:'vei∫(ә)n/
observe	/əbˈzə:v/
obtain	/əb'tein/
obvious	/'ɒbviəs/
obviously	/'ɔbviəsli/
occasion	/əˈkeɪʒən/
occasionally	/з'keiЗnзli/
occupied	/ɔkjupaid/
occupy	/'ɔkjupai/
occur	/ə'kə:/
ocean	/'əuʃ(ə)n/
October (abbr Oct)	/ɔk´toubə/
odd	/ɔd/
oddly	/´ɔdli/
of	/ɔv/
off	/ɔ:f/
offence	/ə'fens/
offend	/ə´fend/
offensive	/ə´fensiv/
offer	/´ɔfə/
office	/'ɔfis/
officer	/´ɔfisə/
official	/ə'fiʃəl/
officially	/ə'fi∫əli/
often	/'ɔ:fn/
oh	/ou/
oil	/ɔɪl/
OK (okay)	/əʊkei/
old	/ould/
old-fashioned	//
on	/on, prep/
once	/wʌns/
one number	/wʌn/
onion	/ˈʌnjən/
only	/'ounli/
onto	/´ɔntu/
open	/'oupən/
opening	/´oupniη/
openly	/´oupənli/
operate	/'ɔpəreit/
operation	/,ɔpə'reiʃn/
opinion	/ə'pinjən/
opponent	/əpəʊ.nənt/
opportunity	/ˌɒpərˈtunɪti , ˌɒpərˈtyunɪti/
oppose	/əˈpoʊz/
opposed to	/ə´pouzd/
opposing	/з'pouziη/
opposite	/'ɔpəzit/
opposition	/¸ɔpə´ziʃən/
option	/'ɔpʃn/
orange	/ɒrɪndʒ/
order	/'ɔ:də/
ordinary	/'o:dinәri/
organ	/'ɔ:gən/
organization	/,ɔ:gənai'zeiʃn/
organize	/´ɔ:gə¸naiz/
organized	/o:gзnaizd/
origin	/'ɔridӡin/
original	/ə'ridʒənl/
originally	/ə'ridʒnəli/
other	/ˈʌðər/
otherwise	/´ʌðə¸waiz/
ought to	/ɔ:t/
our	/auə/
ours	/auəz, pro/
ourselves	/´awə´selvz/
out	/aut/
outdoor	/'autdɔ:/
outdoors	/¸aut´dɔ:z/
outer	//
outline	/´aut¸lain/
output	/'autput/
outside	/'aut'said/
outstanding	/¸aut´stændiη/
oven	/ʌvn/
over	/'ouvə/
overall	/(adv) ˈoʊvərˈɔl/
overcome	/ˌoʊvərˈkʌm/
owe	/ou/
own	/oun/
owner	/´ounə/
p.m. (PM)	/pip'emз/
pace	/peis/
pack	/pæk/
package	/pæk.ɪdʒ/
packaging	/"pækidzŋ/
packet	/'pækit/
page	/peidʒ/
pain	/pein/
painful	/'peinful/
paint	/peint/
painter	/peintə/
painting	/'peintiɳ/
pair	/pɛə/
palace	/ˈpælɪs/
pale	/peil/
pan	/pæn - pɑ:n/
panel	/'pænl/
pants	/pænts/
paper	/´peipə/
parallel	/'pærəlel/
parent	/'peərənt/
park	/pa:k/
parliament	/'pɑ:ləmənt/
part	/pa:t/
particular	/pə´tikjulə/
particularly	/pə´tikjuləli/
partly	/´pa:tli/
partner	/'pɑ:tnə/
partnership	/´pa:tnəʃip/
party	/ˈpɑrti/
pass	/´pa:s/
passage	/ˈpæsɪdʒ/
passenger	/'pæsindʤə/
passing	/´pa:siη/
passport	/´pa:spɔ:t/
past	/pɑ:st/
path	/pɑ:θ/
patience	/´peiʃəns/
patient	/'peiʃənt/
pattern	/'pætə(r)n/
pause	/pɔ:z/
pay	/pei/
pay attention to	//
payment	/'peim(ə)nt/
peace	/pi:s/
peaceful	/'pi:sfl/
peak	/pi:k/
pen	/pen/
pence	/pens/
pencil	/´pensil/
penny	/´peni/
pension	/'penʃn/
people	/ˈpipəl/
pepper	/´pepə/
per	/pə:/
per cent (percent)	//
perfect	/pə'fekt/
perfectly	/´pə:fiktli/
perform	/pə´fɔ:m/
performance	/pə'fɔ:məns/
performer	/pə´fɔ:mə/
perhaps	/pə'hæps/
period	/'piəriəd/
permanent	/'pə:mənənt/
permanently	/'pə:mənəntli/
permission	/pə'miʃn/
permit	/'pə:mit/
person	/ˈpɜrsən/
personal	/'pə:snl/
personality	/pə:sə'næləti/
personally	/´pə:sənəli/
persuade	/pə'sweid/
pet	/pet/
petrol	/ˈpɛtrəl/
phase	/feiz/
philosophy	/fɪˈlɒsəfi/
photocopy	/´foutə¸kɔpi/
photograph (photo)	/´foutə¸gra:f/
photographer	/fə´tɔgrəfə/
photography	/fə´tɔgrəfi/
phrase	/freiz/
physical	/´fizikl/
physically	/´fizikli/
physics	/'fiziks/
piano	/'pjænou/
pick	/pik/
picture	/'piktʃə/
piece	/pi:s/
pig	/pig/
pile	/paɪl/
pill	/´pil/
pilot	/´paiələt/
pin	/pin/
pink	/piηk/
pint	/paint/
pipe	/paip/
pitch	/pit∫/
pity	/´piti/
place	/pleis/
plain	/plein/
plan	/plæn/
plane	/plein/
planet	/´plænit/
planning	/plænniη/
plant	/plænt , plɑnt/
plastic	/'plæstik/
plate	/pleit/
platform	/'plætfɔ:m/
play	/plei/
player	/'pleiз/
pleasant	/'pleznt/
pleasantly	/'plezəntli/
please	/pli:z/
pleased	/pli:zd/
pleasing	/´pli:siη/
pleasure	/ˈplɛʒuə(r)/
plenty	/'plenti/
plot	/plɔt/
plug	/plʌg/
plus	/plʌs/
pocket	/'pɔkit/
poem	/'pouim/
poetry	/'pouitri/
point	//
pointed	/´pɔintid/
poison	/ˈpɔɪzən/
poisonous	/pɔɪ.zə(n)əs/
pole	/poul/
police	/pə'li:s/
policy	/'pol.ə si/
polish	/'pouliʃ/
polite	/pəˈlaɪt/
politely	/pəˈlaɪtli/
political	/pə'litikl/
politically	/pə'litikəli/
politician	/¸pɔli´tiʃən/
politics	/'pɔlitiks/
pollution	/pəˈluʃən/
pool	/pu:l/
poor	/puə/
pop	/pɒp; NAmE pɑːp/
popular	/´pɔpjulə/
population	/,pɔpju'leiʃn/
port	/pɔ:t/
pose	/pouz/
position	/pəˈzɪʃən/
positive	/'pɔzətiv/
possess	/pә'zes/
possession	/pə'zeʃn/
possibility	/¸pɔsi´biliti/
possible	/'pɔsibəl/
possibly	/´pɔsibli/
post	/poʊst/
post office	/'ɔfis/
pot	/pɒt/
potato	/pə'teitou/
potential	/pəˈtɛnʃəl/
potentially	/pəˈtɛnʃəlli/
pound	/paund/
pour	/pɔ:/
powder	/'paudə/
power	/ˈpauə(r)/
powerful	/´pauəful/
practical	/ˈpræktɪkəl/
practically	/´præktikəli/
practice	/´præktis/
practise	/´præktis/
praise	/preiz/
prayer	/prɛər/
precise	/pri´sais/
precisely	/pri´saisli/
predict	/pri'dikt/
prefer	/pri'fə:/
preference	/'prefərəns/
pregnant	/'pregnənt/
premises	/'premis/
preparation	/¸prepə´reiʃən/
prepare	/pri´peə/
prepared	/pri'peəd/
presence	/'prezns/
present	/(v)pri'zent/
presentation	/,prezen'teiʃn/
preserve	/pri'zə:v/
president	/´prezidənt/
press	/pres/
pressure	/'preʃə/
presumably	/pri'zju:məbli/
pretend	/pri'tend/
pretty	/'priti/
prevent	/pri'vent/
previous	/ˈpriviəs/
previously	/´pri:viəsli/
price	/prais/
pride	/praid/
priest	/pri:st/
primarily	/´praimərili/
primary	/'praiməri/
prime minister	/´ministə/
prince	/prins/
princess	/prin'ses/
principle	/ˈprɪnsəpəl/
print	/print/
printer	/´printə/
printing	/´printiη/
prior	/'praɪə(r)/
priority	/prai´ɔriti/
prison	/ˈprɪzən/
prisoner	/ˈprɪzənə(r)/
private	/ˈpraɪvɪt/
privately	/ˈpraɪvɪtli/
prize	/praiz/
probable	/´prɔbəbl/
probably	/´prɔbəbli/
problem	/'prɔbləm/
procedure	/prə´si:dʒə/
proceed	/proceed/
process	/'prouses/
produce	/'prɔdju:s/
producer	/prə´dju:sə/
product	/´prɔdʌkt/
production	/prə´dʌkʃən/
profession	/prə´feʃ(ə)n/
professional	/prə'feʃənl/
professor	/prəˈfɛsər/
profit	/ˈprɒfɪt/
program	/´prougræm/
programme	/´prougræm/
progress	/'prougres/
project	/(n) ˈprɒdʒɛkt/
promise	//
promote	/prəˈmoʊt/
promotion	/prə'mou∫n/
prompt	/prɒmpt/
promptly	/´prɔmptli/
pronounce	/prəˈnaʊns/
pronunciation	/prə¸nʌnsi´eiʃən/
proof	/pru:f/
proper	/'prɔpə/
properly	/´prɔpəli/
property	/'prɔpəti/
proportion	/prə'pɔ:ʃn/
proposal	/prə'pouzl/
propose	/prǝ'prouz/
prospect	/´prɔspekt/
protect	/prə'tekt/
protection	/prə'tek∫n/
protest	/ˈprəʊ.test/
proud	/praud/
proudly	/proudly/
prove	/pru:v/
provide	/prə'vaid/
provided, providing	/prə´vaidid/
pub, publicyhouse	//
public	/'pʌblik/
publication	/ˌpʌblɪˈkeɪʃən/
publicity	/pʌb'lɪsətɪ/
publicly	/'pΔblikli/
publish	/'pʌbli∫/
publishing	/´pʌbliʃiη/
pull	/pul/
punch	/pʌntʃ/
punish	/'pʌniʃ/
punishment	/'pʌniʃmənt/
pupil	/ˈpju:pl/
purchase	/'pə:t∫əs/
pure	/pjuə(r)/
purely	/´pjuəli/
purple	/ˈpɜrpəl/
purpose	/'pə:pəs/
pursue	/pә'sju:/
push	/puʃ/
put	/put/
put sth on	//
qualification	/,kwalifi'keiSn/
qualified	/ˈkwɒləˌfaɪd/
qualify	/´kwɔli¸fai/
quality	/'kwɔliti/
quantity	/ˈkwɒntɪti/
quarter	/'kwɔ:tə/
queen	/kwi:n/
question	/ˈkwɛstʃən/
quick	/kwik/
quickly	/´kwikli/
quiet	/'kwaiət/
quietly	/'kwiətli/
quit	/kwit/
quite	/kwait/
quote	/kwout/
race	/reis/
racing	/´reisiη/
radio	/´reidiou/
rail	/reil/
railway	/'reilwei/
rain	/rein/
raise	/reiz/
range	/reɪndʒ/
rank	/ræɳk/
rapid	/'ræpid/
rapidly	/'ræpidli/
rare	/reə/
rarely	/'reзli/
rate	/reit/
rather	/'rɑ:ðə/
raw	/rɔ:/
re-	//
reach	/ri:tʃ/
react	/ri´ækt/
reaction	/ri:'ækʃn/
read	/ri:d/
reader	/´ri:də/
reading	/´ri:diη/
ready	/'redi/
real	/riəl/
realistic	/ri:ə'listik; BrE also riə-/
reality	/ri:'æliti/
realize	/riәlaiz/
really	/'riəli/
rear	/rɪər/
reason	/'ri:zn/
reasonable	/´ri:zənəbl/
reasonably	/´ri:zənəblli/
recall	/ri´kɔ:l/
receipt	/ri´si:t/
receive	/ri'si:v/
recent	/´ri:sənt/
recently	/´ri:səntli/
reception	/ri'sep∫n/
reckon	/'rekən/
recognition	/,rekəg'niʃn/
recognize	/'rekəgnaiz/
recommend	/rekə'mend/
record	/´rekɔ:d/
recording	/ri´kɔ:diη/
recover	/'ri:'kʌvə/
red	/red/
reduce	/ri'dju:s/
reduction	/ri´dʌkʃən/
refer to	//
reference	/'refərəns/
reflect	/ri'flekt/
reform	/ri´fɔ:m/
refrigerator	/ri'fridЗзreitз/
refusal	/ri´fju:zl/
refuse	/rɪˈfyuz/
regard	/ri'gɑ:d/
regarding	/ri´ga:diη/
region	/'ri:dʒən/
regional	/ˈridʒənl/
register	/'redʤistə/
regret	/ri'gret/
regular	/'rəgjulə/
regularly	/´regjuləli/
regulation	/¸regju´leiʃən/
reject	/'ri:ʤekt/
relate	/ri'leit/
related	/ri'leitid/
relation	/ri'leiʃn/
relationship	/ri'lei∫әn∫ip/
relative	/'relətiv/
relatively	/'relətivli/
relax	/ri´læks/
relaxed	/ri´lækst/
relaxing	/ri'læksiɳ/
release	/ri'li:s/
relevant	/´reləvənt/
relief	/ri'li:f/
religion	/rɪˈlɪdʒən/
religious	/ri'lidʒəs/
rely on	/ri´lai/
remain	/riˈmein/
remaining	/ri´meiniη/
remains	/re'meins/
remark	/ri'mɑ:k/
remarkable	/ri'ma:kәb(ә)l/
remarkably	/ri'ma:kәb(ә)li/
remember	/rɪˈmɛmbər/
remind	/riˈmaind/
remote	/ri'mout/
removal	/ri'mu:vəl/
remove	/ri'mu:v/
rent	/rent/
rented	/rentid/
repair	/ri'peə/
repeat	/ri'pi:t/
repeated	/ri´pi:tid/
repeatedly	/ri´pi:tidli/
replace	/rɪpleɪs/
reply	/ri'plai/
report	/ri'pɔ:t/
represent	/repri'zent/
representative	/,repri'zentətiv/
reproduce	/,ri:prə'dju:s/
reputation	/,repju:'teiʃn/
request	/ri'kwest/
require	/ri'kwaiə(r)/
requirement	/rɪˈkwaɪərmənt/
rescue	/´reskju:/
research	/ri'sз:tʃ/
reservation	/rez.əveɪ.ʃən/
reserve	/ri'zЗ:v/
resident	/'rezidənt/
resist	/ri'zist/
resistance	/ri´zistəns/
resolve	/ri'zɔlv/
resort	/ri´zɔ:t/
resource	/ri'so:s/
respect	/riˈspekt/
respond	/ri'spond/
response	/rɪˈspɒns/
responsibility	/ris,ponsз'biliti/
responsible	/ri'spɔnsəbl/
rest	/rest/
restaurant	/´restərɔn/
restore	/ris´tɔ:/
restrict	/ris´trikt/
restricted	/ris´triktid/
restriction	/ri'strik∫n/
result	/ri'zʌlt/
retain	/ri'tein/
retire	/ri´taiə/
retired	/ri´taiəd/
retirement	/rɪˈtaɪərmənt/
return	/ri'tə:n/
reveal	/riˈvi:l/
reverse	/ri'və:s/
review	/ri´vju:/
revise	/ri'vaiz/
revision	/ri´viʒən/
revolution	/,revə'lu:ʃn/
reward	/ri'wɔ:d/
rhythm	/'riðm/
rice	/raɪs/
rich	/ritʃ/
rid	/rid/
ride	/raid/
rider	/´raidə/
ridiculous	/rɪˈdɪkyələs/
riding	/´raidiη/
right	/rait/
rightly	/´raitli/
ring	/riɳ/
rise	/raiz/
risk	/risk/
rival	/raivl/
river	/'rivə/
road	/roʊd/
rob	/rɔb/
rock	/rɔk/
role	/roul/
roll	/'roul/
romantic	/roʊˈmæntɪk/
roof	/ru:f/
room	/rum/
root	/ru:t/
rope	/roʊp/
rough	/rᴧf/
roughly	/'rʌfli/
round	/raund/
rounded	/´raundid/
route	/ru:t/
routine	/ru:'ti:n/
row	/rou/
royal	/ˈrɔɪəl/
rub	/rʌb/
rubber	/´rʌbə/
rubbish	/ˈrʌbɪʃ/
rude	/ru:d/
rudely	/ru:dli/
ruin	/ru:in/
ruined	/ru:ind/
rule	/ru:l/
ruler	/´ru:lə/
rumour	/ˈrumər/
run	/rʌn/
runner	/´rʌnə/
running	/'rʌniɳ/
rural	/´ruərəl/
rush	/rʌ∫/
sack	/sæk/
sad	/sæd/
sadly	/'sædli/
sadness	/'sædnis/
safe	/seif/
safely	/seifli/
safety	/'seifti/
sail	/seil/
sailing	/'seiliɳ/
sailor	/seilə/
salad	/'sæləd/
salary	/ˈsæləri/
sale	/seil/
salt	/sɔ:lt/
salty	/´sɔ:lti/
same	/seim/
sample	/´sa:mpl/
sand	/sænd/
satisfaction	/,sætis'fæk∫n/
satisfied	/'sætisfaid/
satisfy	/'sætisfai/
satisfying	/sætisfaiiη/
Saturday (abbr Sat)	/'sætədi/
sauce	/sɔ:s/
save	/seiv/
saving	/´seiviη/
say	/sei/
scale	/skeɪl/
scare	/skɛə/
scared	/skerd/
scene	/si:n/
schedule	/´ʃkedju:l/
scheme	/ski:m/
school	/sku:l/
science	/'saiəns/
scientific	/,saiən'tifik/
scientist	/'saiəntist/
scissors	/´sizəz/
score	/skɔ:/
scratch	/skrætʃ/
scream	/skri:m/
screen	/skrin/
screw	/skru:/
sea	/si:/
seal	/si:l/
search	/sə:t∫/
season	/´si:zən/
seat	/si:t/
second	/ˈsɛkənd/
secondary	/´sekəndəri/
secret	/'si:krit/
secretary	/'sekrətri/
secretly	/'si:kritli/
section	/'sekʃn/
sector	/ˈsɛktər/
secure	/si'kjuə/
security	/siˈkiuəriti/
see	/si:/
seed	/sid/
seek	/si:k/
seem linking	/si:m/
select	/si´lekt/
selection	/si'lekʃn/
self	/self/
self-	//
sell	/sel/
senate	/´senit/
senator	/ˈsɛnətər/
send	/send/
senior	/'si:niə/
sense	/sens/
sensible	/'sensəbl/
sensitive	/'sensitiv/
sentence	/'sentəns/
separate	/'seprət/
separated	/'seprətid/
separately	/'seprətli/
separation	/¸sepə´reiʃən/
September	/sep´tembə/
series	/ˈsɪəriz/
serious	/'siәriәs/
seriously	/siəriəsli/
servant	/'sə:vənt/
serve	/sɜ:v/
service	/'sə:vis/
session	/'seʃn/
set	/set/
settle	/ˈsɛtl/
several	/'sevrəl/
severe	/səˈvɪər/
severely	/sə´virli/
sew	/soʊ/
sewing	/´souiη/
sex	/seks/
sexual	/'seksjuəl/
sexually	/'sekSJli/
shade	/ʃeid/
shadow	/ˈʃædəu/
shake	/ʃeik/
shall	/ʃæl/
shallow	/ʃælou/
shame	/ʃeɪm/
shape	/ʃeip/
shaped	/ʃeipt/
share	/ʃeə/
sharp	/ʃɑrp/
sharply	/ʃɑrpli/
shave	/ʃeiv/
she	/ʃi:/
sheep	/ʃi:p/
sheet	/ʃi:t/
shelf	/ʃɛlf/
shell	/ʃɛl/
shelter	/'ʃeltə/
shift	/ʃift/
shine	/ʃain/
shiny	/∫aini/
ship	/ʃɪp/
shirt	/ʃɜːt/
shock	/Sok/
shocked	/Sok/
shocking	/´ʃɔkiη/
shoe	/ʃu:/
shoot	/ʃut/
shooting	/'∫u:tiη/
shop	/ʃɔp/
shopping	/'ʃɔpiɳ/
short	/ʃɔ:t/
shortly	/´ʃɔ:tli/
shot	/ʃɔt/
should	/ʃud, ʃəd, ʃd/
shoulder	/'ʃouldə/
shout	/ʃaʊt/
show	/ʃou/
shower	/´ʃouə/
shut	/ʃʌt/
shy	/ʃaɪ/
sick	/sick/
side	/said/
side	/sait/
sideways	/´saidwə:dz/
sight	/sait/
sign	/sain/
signal	/'signəl/
signature	/ˈsɪgnətʃər , ˈsɪgnəˌtʃʊər/
significant	/sɪgˈnɪfɪkənt/
significantly	/sig'nifikəntli/
silence	/ˈsaɪləns/
silent	/ˈsaɪlənt/
silk	/silk/
silly	/´sili/
silver	/'silvə/
similar	/´similə/
similarly	/´similəli/
simple	/'simpl/
simply	/´simpli/
since	/sins/
sincere	/sin´siə/
sincerely	/sin'siəli/
sing	/siɳ/
singer	/´siηə/
singing	/´siηiη/
single	/'siɳgl/
sink	/sɪŋk/
sir	/sə:/
sister	/'sistə/
sit	/sit/
situation	/,sit∫u'ei∫n/
size	/saiz/
skilful	/´skilful/
skilfully	/´skilfulli/
skill	/skil/
skilled	/skild/
skin	/skin/
skirt	/skɜːrt/
sky	/skaɪ/
sleep	/sli:p/
sleeve	/sli:v/
slice	/slais/
slide	/slaid/
slight	/slait/
slightly	/'slaitli/
slip	/slip/
slope	/sloup/
slow	/slou/
slowly	/'slouli/
small	/smɔ:l/
smart	/sma:t/
smash	/smæʃ/
smell	/smɛl/
smile	/smail/
smoke	/smouk/
smoking	/smoukiη/
smooth	/smu:ð/
smoothly	/smu:ðli/
snake	/sneik/
snow	/snou/
so	/sou/
soap	/soup/
social	/'sou∫l/
socially	/´souʃəli/
society	/sə'saiəti/
sock	/sɔk/
soft	/sɔft/
softly	/sɔftli/
software	/'sɔfweз/
soil	/sɔɪl/
soldier	/'souldʤə/
solid	/'sɔlid/
solution	/sə'lu:ʃn/
solve	/sɔlv/
some	/sʌm/
somebody, someone	/'sʌmbədi/
somehow	/´sʌm¸hau/
something	/'sʌmθiɳ/
sometimes	/´sʌm¸taimz/
somewhat	/´sʌm¸wɔt/
somewhere	/'sʌmweə/
son	/sʌn/
song	/sɔɳ/
soon	/su:n/
sore	/sɔr , soʊr/
sorry	/'sɔri/
sort	/sɔ:t/
soul	/soʊl/
sound	/sound/
soup	/su:p/
sour	/'sauə/
source	/sɔ:s/
south	/sauθ/
southern	/´sʌðən/
space	/speis/
spare	/speə/
speak	/spi:k/
speaker	/ˈspikər/
special	/'speʃəl/
specialist	/'spesʃlist/
specially	/´speʃəli/
specific	/spi'sifik/
specifically	/spi'sifikəli/
speech	/spi:tʃ/
speed	/spi:d/
spell	/spel/
spelling	/´speliη/
spend	/spɛnd/
spice	/spais/
spicy	/´spaisi/
spider	/´spaidə/
spin	/spin/
spirit	/ˈspɪrɪt/
spiritual	/'spiritjuəl/
spite	/spait/
split	/split/
spoil	/spɔil/
spoken	/spoukn/
spoon	/spu:n/
sport	/spɔ:t/
spot	/spɔt/
spray	/spreɪ/
spread	/spred/
spring	/sprɪŋ/
square	/skweə/
squeeze	/skwi:z/
stable	/steibl/
staff	/sta:f/
stage	/steɪdʒ/
stair	/steə/
stamp	/stæmp/
stand	/stænd/
standard	/'stændəd/
star	/stɑ:/
stare	/'steә(r)/
start	/stɑ:t/
state	/steit/
statement	/'steitmənt/
station	/'steiʃn/
statue	/'stæt∫u:/
status	/ˈsteɪtəs , ˈstætəs/
stay	/stei/
steadily	/'stedili/
steady	/'stedi/
steal	/sti:l/
steam	/stim/
steel	/sti:l/
steep	/sti:p/
steeply	/'sti:pli/
steer	/stiə/
step	/step/
stick	/stick/
stick out, stick for	//
sticky	/'stiki/
stiff	/stif/
stiffly	/'stifli/
still	/stil/
sting	/stiɳ/
stir	/stə:/
stock	/stə:/
stomach	/ˈstʌmək/
stone	/stoun/
stop	/stɔp/
store	/stɔ:/
storm	/stɔ:m/
story	/'stɔ:ri/
stove	/stouv/
straight	/streɪt/
strain	/strein/
strange	/streindʤ/
strangely	/streindʤli/
stranger	/'streinʤə/
strategy	/'strætəʤɪ/
stream	/stri:m/
strength	/'streɳθ/
stress	//
stressed	/strest/
stretch	/strɛtʃ/
strict	/strikt/
strictly	/striktli/
strike	/straik/
striking	/'straikiɳ/
string	/strɪŋ/
strip	/strip/
stripe	/straɪp/
striped	/straipt/
stroke	/strouk/
strong	/strɔŋ , strɒŋ/
strongly	/strɔŋli/
structure	/'strʌkt∫ə/
struggle	/'strʌg(ә)l/
student	/'stju:dnt/
studio	/´stju:diou/
study	/'stʌdi/
stuff	/stʌf/
stupid	/ˈstupɪd , ˈstyupɪd/
style	/stail/
subject	/ˈsʌbdʒɪkt/
substance	/'sʌbstəns/
substantial	/səb´stænʃəl/
substantially	/səb´stænʃəli/
substitute	/´sʌbsti¸tju:t/
succeed	/sәk'si:d/
success	/sәk'si:d/
successful	/səkˈsɛsfəl/
successfully	/səkˈsɛsfəlli/
such	/sʌtʃ/
suck	/sʌk/
sudden	/'sʌdn/
suddenly	/'sʌdnli/
suf	/stri:t/
suffer	/'sΛfә(r)/
suffering	/'sΛfәriŋ/
sufficient	/sə'fi∫nt/
sufficiently	/sə'fiʃəntli/
sugar	/'ʃugə/
suggest	/sə'dʤest/
suggestion	/sə'dʤestʃn/
suit	/su:t/
suitable	/´su:təbl/
suitcase	/´su:t¸keis/
suited	/´su:tid/
sum	/sʌm/
summary	/ˈsʌməri/
summer	/ˈsʌmər/
sun	/sʌn/
Sunday	/´sʌndi/
superior	/su:'piәriә(r)/
supermarket	/´su:pə¸ma:kit/
supply	/sə'plai/
support	/sə´pɔ:t/
supporter	/sə´pɔ:tə/
suppose	/sә'pәƱz/
sure	/ʃuə/
surely	/´ʃuəli/
surface	/ˈsɜrfɪs/
surname	/ˈsɜrˌneɪm/
surprise	/sə'praiz/
surprised	/sə:´praizd/
surprising	/sə:´praiziη/
surprisingly	/sə'praiziηli/
surround	/sә'raƱnd/
surrounding	/sə.ˈrɑʊ(n)diɳ/
surroundings	/sə´raundiηz/
survey	/'sə:vei/
survive	/sə'vaivə/
suspect	/səs´pekt/
suspicion	/səs'pi∫n/
suspicious	/səs´piʃəs/
swallow	/'swɔlou/
swear	/sweə/
swearing	//
sweat	/swet/
sweater	/'swetз/
sweep	/swi:p/
sweet	/swi:t/
swell	/swel/
swelling	/´sweliη/
swim	/swim/
swimming	/´swimiη/
swimming pool	//
swing	/swiŋ/
switch	/switʃ/
swollen	/´swoulən/
swollen swell	/´swoulən, swel/
symbol	/simbl/
sympathetic	/¸simpə´θetik/
sympathy	/´simpəθi/
system	/'sistim/
table	/'teibl/
tablet	/'tæblit/
tackle	/tækl or 'teikl/
tail	/teil/
take	/teik/
take care of	//
take part in	//
take sth over	//
talk	/tɔ:k/
tall	/tɔ:l/
tank	/tæŋk/
tap	/tæp/
tape	/teip/
target	/'ta:git/
task	/tɑːsk/
taste	/teist/
tax	/tæks/
taxi	/'tæksi/
tea	/ti:/
teach	/ti:tʃ/
teacher	/'ti:t∫ə/
teaching	/'ti:t∫iŋ/
team	/ti:m/
tear	/tiə/
technical	/'teknikl/
technique	/tek'ni:k/
technology	/tek'nɔlədʤi/
telephone (phone)	/´telefoun/
television (TV)	/´televiʒn/
tell	/tel/
temperature	/´tempritʃə/
temporarily	/'tempзrзlti/
temporary	/ˈtɛmpəˌrɛri/
tend	/tend/
tendency	/ˈtɛndənsi/
tension	/'tenʃn/
tent	/tent/
term	/tɜ:m/
terrible	/'terəbl/
terribly	/'terəbli/
test	/test/
text	/tɛkst/
than	/ðæn/
thank	/θæŋk/
thank you	//
thanks	/'θæŋks/
that	/ðæt/
the	/ði:, ði, ðз/
theatre	/ˈθiətər/
their	/ðea(r)/
theirs	/ðeəz/
them	/ðem/
theme	/θi:m/
themselves	/ðəm'selvz/
then	/ðen/
theory	/'θiəri/
there	/ðeз/
therefore	/'ðeəfɔ:(r)/
they	/ðei/
thick	/θik/
thickly	/θikli/
thickness	/´θiknis/
thief	/θi:f/
thin	/θin/
thing	/θiŋ/
think	/θiŋk/
thinking	/'θiŋkiŋ/
thirsty	/´θə:sti/
this	/ðis/
thorough	/'θʌrə/
thoroughly	/'θʌrəli/
though	/ðəʊ/
thought	/θɔ:t/
thread	/θred/
threat	/θrɛt/
threaten	/'θretn/
threatening	/´θretəniη/
throat	/θrout/
through	/θru:/
throughout	/θru:'aut/
throw	/θrou/
thumb	/θʌm/
Thursday (abbr Thur, Thurs)	/´θə:zdi/
thus	/ðʌs/
ticket	/'tikit/
tidy	/´taidi/
tie	/tai/
tight	/tait/
tightly	/'taitli/
till, until	/til/
time	/taim/
timetable	/´taimteibl/
tin	/tɪn/
tiny	/'taini/
tip	/tip/
tire	/taiз/
tired	/'taɪəd/
tiring	/´taiəriη/
title	/ˈtaɪtl/
to	/tu:, tu, tз/
today	/tə'dei/
toe	/tou/
together	/tə'geðə/
toilet	/´tɔilit/
tomato	/tə´ma:tou/
tomorrow	/tə'mɔrou/
ton	/tΔn/
tone	/toun/
tongue	/tʌη/
tonight	/tə´nait/
tonne	/tʌn/
too	/tu:/
tool	/tu:l/
tooth	/tu:θ/
top	/tɒp/
topic	/ˈtɒpɪk/
total	/'toutl/
totally	/toutli/
touch	/tʌtʃ/
tough	/tʌf/
tour	/tuə/
tourist	/'tuərist/
towards	/tə´wɔ:dz/
towel	/taʊəl/
tower	/'tauə/
town	/taun/
toy	/tɔi/
trace	/treis/
track	/træk/
trade	/treid/
trading	/treidiη/
tradition	/trə´diʃən/
traditional	/trə´diʃənəl/
traditionally	/trə´diʃənəlli/
traffic	/'træfik/
train	/trein/
training	/trainiŋ/
transfer	/'trænsfə:/
transform	/træns'fɔ:m/
translate	/træns´leit/
translation	/træns'leiʃn/
transparent	/træns´pærənt/
transport	/'trænspɔ:t/
trap	/træp/
travel	/'trævl/
traveller	/'trævlə/
treat	/tri:t/
treatment	/'tri:tmənt/
tree	/tri:/
trend	/trend/
trial	/'traiəl/
triangle	/´trai¸æηgl/
trick	/trik/
trip	/trip/
tropical	/´trɔpikəl/
trouble	/'trʌbl/
trousers	/´trauzə:z/
truck	/trʌk/
true	/tru:/
truly	/'tru:li/
trust	/trʌst/
truth	/tru:θ/
try	/trai/
tube	/tju:b/
Tuesday (abbr Tue, Tues)	/´tju:zdi/
tune	/tun , tyun/
tunnel	/'tʌnl/
turn	/tə:n/
TV television	//
twice	/twaɪs/
twin	/twɪn/
twist	/twist/
twisted	/twistid/
type	/taip/
typical	/´tipikəl/
typically	/´tipikəlli/
tyre	/'taiз/
ugly	/'ʌgli/
ultimate	/ˈʌltəmɪt/
ultimately	/´ʌltimətli/
umbrella	/ʌm'brelə/
unable	/'ʌn'eibl/
unacceptable	/'ʌnək'septəbl/
unacceptable, acceptable	/¸ʌnək´septəbl/
uncertain	/ʌn'sə:tn/
uncertain, certain	/ʌn'sə:tn/
uncle	/ʌηkl/
uncomfortable	/ʌη´tkʌmfətəbl/
uncomfortable,comfortable	/ʌη´kʌmfətəbl/
unconscious	/ʌn'kɔnʃəs/
unconscious, conscious	/ʌn'kɔnʃəs/
uncontrolled	/'ʌnkən'trould/
uncontrolled, control	/'ʌnkən'trould/
under	/'ʌndə/
underground	/ʌndəgraund/
underneath	/¸ʌndə´ni:θ/
understand	/ʌndə'stænd/
understanding	/ˌʌndərˈstændɪŋ/
underwater	/´ʌndə¸wɔtə/
underwear	/'ʌndəweə/
undo	/ʌn´du:/
unemployed	/¸ʌnim´plɔid/
unemployment	/'Δnim'ploimзnt/
unexpected	/¸ʌniks´pektid/
unexpectedly	/'Δniks'pektid/
unfair	/ʌn´fɛə/
Unfair, unfairly	/ʌn´fɛə/
unfairly	/ʌn´fɛəli/
unfortunate	/Λnfo:'t∫әneit/
unfortunately	/ʌn´fɔ:tʃənətli/
unfriendly	/ʌn´frendli/
unhappiness	/ʌn´hæpinis/
unhappy	/ʌn´hæpi/
uniform	/ˈjunəˌfɔrm/
unimportant	/¸ʌnim´pɔ:tənt/
union	/'ju:njən/
unique	/ju:´ni:k/
unit	/'ju:nit/
unite	/ju:´nait/
united	/ju:'naitid/
universe	/'ju:nivə:s/
university	/¸ju:ni´və:siti/
unkind	/ʌn´kaind/
unknown	/'ʌn'noun/
unless	/ʌn´les/
unlike	/ʌn´laik/
unlikely	/ʌnˈlaɪkli/
unload	/ʌn´loud/
unlucky	/ʌn´lʌki/
unnecessary	/ʌn'nesisəri/
unpleasant	/ʌn'plezənt/
unreasonable	/ʌnˈrizənəbəl/
unsteady	/ʌn´stedi/
unsuccessful	/¸ʌnsək´sesful/
untidy	/ʌn´taidi/
until, till	/ʌn´til/
Unusual	/ʌn´ju:ʒuəl/
unusually	/ʌn´ju:ʒuəlli/
Unwilling	/ʌn´wiliη/
unwillingly	/ʌn´wiliηgli/
up	/Λp/
upon	/ə´pɔn/
upper	/´ʌpə/
upset	/ʌpˈsɛt/
upsetting	/ʌp´setiη/
upside down	/´ʌp¸said/
upstairs	/´ʌp´stɛəz/
upward	/'ʌpwəd/
upwards	//
urban	/ˈɜrbən/
urge	/ə:dʒ/
urgent	/ˈɜrdʒənt/
us	/ʌs/
use	/ju:s/
used	/ju:st/
used to	//
useful	/´ju:sful/
useless	/'ju:slis/
user	/´ju:zə/
usual	/'ju:ʒl/
usually	/'ju:ʒәli/
vacation	/və'kei∫n/
valid	/'vælɪd/
valley	/'væli/
valuable	/'væljuəbl/
value	/'vælju:/
van	/væn/
variation	/¸veəri´eiʃən/
varied	/'veərid/
variety	/və'raiəti/
various	/veri.əs/
vary	/'veəri/
vast	/vɑ:st/
vegetable	/ˈvɛdʒtəbəl , ˈvɛdʒɪtəbəl/
vehicle	/'vi:hikl/
venture	/'ventʃə/
version	/'və:∫n/
vertical	/ˈvɜrtɪkəl/
very	/'veri/
via	/'vaiə/
victim	/'viktim/
victory	/'viktəri/
video	/'vidiou/
view	/vju:/
village	/ˈvɪlɪdʒ/
violence	/ˈvaɪələns/
violent	/'vaiələnt/
violently	/vaiзlзntli/
virtually	/'və:tjuəli/
virus	/'vaiərəs/
visible	/'vizəbl/
vision	/'viʒn/
visit	/vizun/
visitor	/'vizitə/
vital	/'vaitl/
vocabulary	/və´kæbjuləri/
voice	/vɔis/
volume	/´vɔlju:m/
vote	/voʊt/
wage	/weiʤ/
waist	/weist/
wait	/weit/
waiter, waitress	/'weitə/
wake up	/weik/
walk	/wɔ:k/
walking	/'wɔ:kiɳ/
wall	/wɔ:l/
wallet	/'wolit/
wander	/'wɔndə/
want	/wɔnt/
war	/wɔ:/
warm	/wɔ:m/
warmth	/wɔ:mθ/
warn	/wɔ:n/
warning	/'wɔ:niɳ/
wash	/wɒʃ , wɔʃ/
washing	/'wɔʃiɳ/
waste	/weɪst/
watch	/wɔtʃ/
water	/'wɔ:tə/
wave	/weɪv/
way	/wei/
we	/wi:/
weak	/wi:k/
weakness	/´wi:knis/
wealth	/welθ/
weapon	/'wepən/
wear	/weə/
weather	/'weθə/
web	/wɛb/
website	//
wedding	/ˈwɛdɪŋ/
Wednesday	/´wensdei/
week	/wi:k/
weekend	/¸wi:k´end/
weekly	/´wi:kli/
weigh	/wei/
weight	/'weit/
welcome	/'welkʌm/
well	/wel/
well known	/´wel´noun/
west	/west/
western	/'westn/
wet	/wɛt/
what	/wʌt/
whatever	/wɔt´evə/
wheel	/wil/
when	/wen/
whenever	/wen'evə/
where	/weər/
whereas	/weə'ræz/
wherever	/weər'evə(r)/
whether	/´weðə/
which	/witʃ/
while	/wail/
whilst	/wailst/
whisper	/´wispə/
whistle	/wisl/
white	/wai:t/
who	/hu:/
whoever	/hu:'ev/
whole	/həʊl/
whom	/hu:m/
whose	/hu:z/
why	/wai/
wide	/waid/
widely	/´waidli/
width	/wɪdθ; wɪtθ/
wife	/waif/
wild	/waɪld/
wildly	/waɪldli/
will	/wil/
willing	/´wiliη/
willingly	/'wiliηli/
willingness	/´wiliηnis/
win	/win/
wind	/wind/
window	/'windəʊ/
wine	/wain/
wing	/wiη/
winner	/winər/
winning	/´winiη/
winter	/ˈwɪntər/
wire	/waiə/
wise	/waiz/
wish	/wi∫/
with	/wið/
withdraw	/wɪðˈdrɔ , wɪθˈdrɔ/
within	/wið´in/
without	/wɪðˈaʊt , wɪθaʊt/
witness	/'witnis/
woman	/'wʊmən/
wonder	/'wʌndə/
wonderful	/´wʌndəful/
wood	/wud/
wooden	/´wudən/
wool	/wul/
work	/wɜ:k/
worker	/'wə:kə/
working	/´wə:kiη/
world	/wɜ:ld/
worried	/´wʌrid/
worry	/'wʌri/
worrying	/´wʌriiη/
worse, worst	/bad/
worship	/ˈwɜrʃɪp/
worth	/wɜrθ/
would	/wud/
wound	/waund/
wounded	/'wu:ndid/
wrap	/ræp/
wrapping	/'ræpiɳ/
wrist	/rist/
write	/rait/
writer	/'raitə/
writing	/´raitiη/
written	/'ritn/
wrong	/rɔɳ/
wrongly	/´rɔηgli/
yard	/ja:d/
yawn	/jɔ:n/
yeah	/jeə/
year	/jə:/
yellow	/'jelou/
yes	/jes/
yesterday	/'jestədei/
yet	/yet/
you	/ju:/
young	/jʌɳ/
your	/jo:/
yours	/jo:z/
Yours sincerely	//
Yours Truly	//
yourself	/jɔ:'self/
youth	/ju:θ/
zero number	/'ziərou/
zone	/zoun/
